"";"Datum";"bula";"Bevölkerung";"EingetrageneImpfungen";"Teilgeimpfte";"Vollimmunisierte";"Datum_minus7";"vollimmun_minus7";"delta_vollimm";"vollimm_jeTag_last7";"DeltaNonImmBev";"dauerDeltaNonimmBev";"TagErreichenImmunquote";"ImpfquoteAct"
"1";"2021-03-25";"Burgenland";294436;51305;37775;13530;"2021-03-18";10819;2711;387,285714285714;192575;497;"2022-08-04";0,0459522612723988
"2";"2021-03-25";"Kärnten";561293;98718;68582;30136;"2021-03-18";26394;3742;534,571428571429;362769;679;"2023-02-02";0,0536903186036526
"3";"2021-03-25";"Niederösterreich";1684287;287585;211902;75683;"2021-03-18";62312;13371;1910,14285714286;1103318;578;"2022-10-24";0,0449347409319196
"4";"2021-03-25";"Oberösterreich";1490279;226798;167719;59079;"2021-03-18";49531;9548;1364;984116;721;"2023-03-16";0,0396429125016188
"5";"2021-03-25";"Salzburg";558410;82170;58794;23376;"2021-03-18";16386;6990;998,571428571429;367511;368;"2022-03-28";0,0418617145108433
"6";"2021-03-25";"Steiermark";1246395;178905;121176;57729;"2021-03-18";37557;20172;2881,71428571429;814747;283;"2022-01-02";0,0463167775865596
"7";"2021-03-25";"Tirol";757634;162322;132930;29392;"2021-03-18";23581;5811;830,142857142857;500952;603;"2022-11-18";0,0387944574821088
"8";"2021-03-25";"Vorarlberg";397139;71272;53480;17792;"2021-03-18";15306;2486;355,142857142857;260205;733;"2023-03-28";0,0448004351121396
"9";"2021-03-25";"Wien";1911191;270727;204433;66294;"2021-03-18";59734;6560;937,142857142857;1271540;1357;"2024-12-11";0,03468727092164
"10";"2021-03-24";"Burgenland";294436;49868;37515;12353;"2021-03-17";9393;2960;422,857142857143;193752;458;"2022-06-25";0,0419547881373202
"11";"2021-03-24";"Kärnten";561293;96186;66349;29837;"2021-03-17";25283;4554;650,571428571429;363068;558;"2022-10-03";0,0531576199952609
"12";"2021-03-24";"Niederösterreich";1684287;277561;204815;72746;"2021-03-17";60436;12310;1758,57142857143;1106255;629;"2022-12-13";0,0431909763597297
"13";"2021-03-24";"Oberösterreich";1490279;218692;161916;56776;"2021-03-17";47785;8991;1284,42857142857;986419;768;"2023-05-01";0,0380975642815875
"14";"2021-03-24";"Salzburg";558410;79430;57937;21493;"2021-03-17";15651;5842;834,571428571429;369394;443;"2022-06-10";0,0384896402285059
"15";"2021-03-24";"Steiermark";1246395;171201;119232;51969;"2021-03-17";37157;14812;2116;820507;388;"2022-04-16";0,0416954496768681
"16";"2021-03-24";"Tirol";757634;157763;129201;28562;"2021-03-17";22426;6136;876,571428571429;501782;572;"2022-10-17";0,0376989417053617
"17";"2021-03-24";"Vorarlberg";397139;69883;52095;17788;"2021-03-17";15270;2518;359,714285714286;260209;723;"2023-03-17";0,0447903630718716
"18";"2021-03-24";"Wien";1911191;261162;196907;64255;"2021-03-17";59065;5190;741,428571428571;1273579;1718;"2025-12-06";0,0336203969148034
"19";"2021-03-23";"Burgenland";294436;48935;37391;11544;"2021-03-16";8412;3132;447,428571428571;194561;435;"2022-06-01";0,0392071621676697
"20";"2021-03-23";"Kärnten";561293;93470;64578;28892;"2021-03-16";24299;4593;656,142857142857;364013;555;"2022-09-29";0,0514740073366317
"21";"2021-03-23";"Niederösterreich";1684287;268535;199051;69484;"2021-03-16";58276;11208;1601,14285714286;1109517;693;"2023-02-14";0,0412542517991292
"22";"2021-03-23";"Oberösterreich";1490279;212647;157565;55082;"2021-03-16";46464;8618;1231,14285714286;988113;803;"2023-06-04";0,03696086437506
"23";"2021-03-23";"Salzburg";558410;76748;57347;19401;"2021-03-16";15056;4345;620,714285714286;371486;598;"2022-11-11";0,0347432889812145
"24";"2021-03-23";"Steiermark";1246395;162915;117482;45433;"2021-03-16";36872;8561;1223;827043;676;"2023-01-28";0,0364515262015653
"25";"2021-03-23";"Tirol";757634;154043;126342;27701;"2021-03-16";21568;6133;876,142857142857;502643;574;"2022-10-18";0,0365625090743024
"26";"2021-03-23";"Vorarlberg";397139;69869;52081;17788;"2021-03-16";13451;4337;619,571428571429;260209;420;"2022-05-17";0,0447903630718716
"27";"2021-03-23";"Wien";1911191;257437;194028;63409;"2021-03-16";58605;4804;686,285714285714;1274425;1857;"2026-04-23";0,0331777410002454
"28";"2021-03-22";"Burgenland";294436;48791;37291;11500;"2021-03-15";8380;3120;445,714285714286;194605;437;"2022-06-02";0,0390577239196294
"29";"2021-03-22";"Kärnten";561293;91550;62694;28856;"2021-03-15";23262;5594;799,142857142857;364049;456;"2022-06-21";0,051409869711541
"30";"2021-03-22";"Niederösterreich";1684287;261782;194179;67603;"2021-03-15";56671;10932;1561,71428571429;1111398;712;"2023-03-04";0,0401374587585132
"31";"2021-03-22";"Oberösterreich";1490279;207429;153882;53547;"2021-03-15";44883;8664;1237,71428571429;989648;800;"2023-05-31";0,0359308559001368
"32";"2021-03-22";"Salzburg";558410;74160;56704;17456;"2021-03-15";14432;3024;432;373431;864;"2023-08-03";0,0312601851686037
"33";"2021-03-22";"Steiermark";1246395;153794;115750;38044;"2021-03-15";36383;1661;237,285714285714;834432;3517;"2030-11-07";0,0305232289924141
"34";"2021-03-22";"Tirol";757634;150957;123783;27174;"2021-03-15";20796;6378;911,142857142857;503170;552;"2022-09-25";0,0358669225509943
"35";"2021-03-22";"Vorarlberg";397139;69644;51917;17727;"2021-03-15";13442;4285;612,142857142857;260270;425;"2022-05-21";0,0446367644577843
"36";"2021-03-22";"Wien";1911191;252304;189977;62327;"2021-03-15";58034;4293;613,285714285714;1275507;2080;"2026-12-01";0,0326116018754797
"37";"2021-03-21";"Burgenland";294436;48663;37181;11482;"2021-03-14";8348;3134;447,714285714286;194623;435;"2022-05-30";0,0389965900908856
"38";"2021-03-21";"Kärnten";561293;90879;62039;28840;"2021-03-14";23078;5762;823,142857142857;364065;442;"2022-06-06";0,0513813641003896
"39";"2021-03-21";"Niederösterreich";1684287;256298;189229;67069;"2021-03-14";55991;11078;1582,57142857143;1111932;703;"2023-02-22";0,0398204106544787
"40";"2021-03-21";"Oberösterreich";1490279;205296;151898;53398;"2021-03-14";44688;8710;1244,28571428571;989797;795;"2023-05-25";0,0358308746214635
"41";"2021-03-21";"Salzburg";558410;73244;56247;16997;"2021-03-14";14248;2749;392,714285714286;373890;952;"2023-10-29";0,0304382084848051
"42";"2021-03-21";"Steiermark";1246395;152120;114341;37779;"2021-03-14";36051;1728;246,857142857143;834697;3381;"2030-06-23";0,0303106158160134
"43";"2021-03-21";"Tirol";757634;148881;121974;26907;"2021-03-14";20066;6841;977,285714285714;503437;515;"2022-08-18";0,0355145096444985
"44";"2021-03-21";"Vorarlberg";397139;69540;51838;17702;"2021-03-14";13442;4260;608,571428571429;260295;428;"2022-05-23";0,0445738142061092
"45";"2021-03-21";"Wien";1911191;246377;185003;61374;"2021-03-14";56730;4644;663,428571428571;1276460;1924;"2026-06-27";0,0321129599291751
"46";"2021-03-20";"Burgenland";294436;46972;35501;11471;"2021-03-13";8348;3123;446,142857142857;194634;436;"2022-05-30";0,0389592305288755
"47";"2021-03-20";"Kärnten";561293;89691;60860;28831;"2021-03-13";21023;7808;1115,42857142857;364074;326;"2022-02-09";0,051365329694117
"48";"2021-03-20";"Niederösterreich";1684287;252745;187005;65740;"2021-03-13";55706;10034;1433,42857142857;1113261;777;"2023-05-06";0,03903135273264
"49";"2021-03-20";"Oberösterreich";1490279;204410;151535;52875;"2021-03-13";44674;8201;1171,57142857143;990320;845;"2023-07-13";0,0354799336231672
"50";"2021-03-20";"Salzburg";558410;73138;56143;16995;"2021-03-13";14223;2772;396;373892;944;"2023-10-20";0,0304346268870543
"51";"2021-03-20";"Steiermark";1246395;151894;114119;37775;"2021-03-13";36033;1742;248,857142857143;834701;3354;"2030-05-26";0,0303074065605205
"52";"2021-03-20";"Tirol";757634;147533;120693;26840;"2021-03-13";20025;6815;973,571428571429;503504;517;"2022-08-19";0,035426076443243
"53";"2021-03-20";"Vorarlberg";397139;66215;50151;16064;"2021-03-13";13441;2623;374,714285714286;261933;699;"2023-02-17";0,0404493137163562
"54";"2021-03-20";"Wien";1911191;241815;180528;61287;"2021-03-13";56709;4578;654;1276547;1952;"2026-07-24";0,0320674385762595
"55";"2021-03-19";"Burgenland";294436;44745;33387;11358;"2021-03-12";8225;3133;447,571428571429;194747;435;"2022-05-28";0,0385754459373174
"56";"2021-03-19";"Kärnten";561293;85993;59428;26565;"2021-03-12";18942;7623;1089;366340;336;"2022-02-18";0,0473282225148006
"57";"2021-03-19";"Niederösterreich";1684287;235293;171167;64126;"2021-03-12";55281;8845;1263,57142857143;1114875;882;"2023-08-18";0,0380730837440412
"58";"2021-03-19";"Oberösterreich";1490279;200547;148933;51614;"2021-03-12";44602;7012;1001,71428571429;991581;990;"2023-12-04";0,0346337833385561
"59";"2021-03-19";"Salzburg";558410;72780;55851;16929;"2021-03-12";14173;2756;393,714285714286;373958;950;"2023-10-25";0,0303164341612793
"60";"2021-03-19";"Steiermark";1246395;146743;109047;37696;"2021-03-12";35311;2385;340,714285714286;834780;2450;"2027-12-03";0,0302440237645369
"61";"2021-03-19";"Tirol";757634;142872;118818;24054;"2021-03-12";18973;5081;725,857142857143;506290;698;"2023-02-15";0,0317488391492462
"62";"2021-03-19";"Vorarlberg";397139;64859;48799;16060;"2021-03-12";13441;2619;374,142857142857;261937;700;"2023-02-17";0,0404392416760882
"63";"2021-03-19";"Wien";1911191;235856;175545;60311;"2021-03-12";56310;4001;571,571428571429;1277523;2235;"2027-05-02";0,031556762249299
"64";"2021-03-18";"Burgenland";294436;42689;31870;10819;"2021-03-11";8039;2780;397,142857142857;195286;492;"2022-07-23";0,0367448273988235
"65";"2021-03-18";"Kärnten";561293;84871;58477;26394;"2021-03-11";18585;7809;1115,57142857143;366511;329;"2022-02-10";0,0470235687956201
"66";"2021-03-18";"Niederösterreich";1684287;224683;162371;62312;"2021-03-11";54205;8107;1158,14285714286;1116689;964;"2023-11-07";0,0369960701471899
"67";"2021-03-18";"Oberösterreich";1490279;191132;141601;49531;"2021-03-11";44440;5091;727,285714285714;993664;1366;"2024-12-13";0,0332360584830089
"68";"2021-03-18";"Salzburg";558410;70378;53992;16386;"2021-03-11";13698;2688;384;374501;975;"2023-11-18";0,0293440303719489
"69";"2021-03-18";"Steiermark";1246395;136135;98578;37557;"2021-03-11";34752;2805;400,714285714286;834919;2084;"2026-12-01";0,0301325021361607
"70";"2021-03-18";"Tirol";757634;139996;116415;23581;"2021-03-11";18063;5518;788,285714285714;506763;643;"2022-12-21";0,031124527146353
"71";"2021-03-18";"Vorarlberg";397139;62898;47592;15306;"2021-03-11";13353;1953;279;262691;942;"2023-10-16";0,038540662085567
"72";"2021-03-18";"Wien";1911191;230751;171017;59734;"2021-03-11";54595;5139;734,142857142857;1278100;1741;"2025-12-23";0,0312548562650201
"73";"2021-03-17";"Burgenland";294436;40531;31138;9393;"2021-03-10";7282;2111;301,571428571429;196712;652;"2022-12-29";0,0319016696327895
"74";"2021-03-17";"Kärnten";561293;82209;56926;25283;"2021-03-10";18303;6980;997,142857142857;367622;369;"2022-03-21";0,0450442104212951
"75";"2021-03-17";"Niederösterreich";1684287;216498;156062;60436;"2021-03-10";52683;7753;1107,57142857143;1118565;1010;"2023-12-22";0,0358822457217802
"76";"2021-03-17";"Oberösterreich";1490279;181241;133456;47785;"2021-03-10";44229;3556;508;995410;1959;"2026-07-28";0,0320644657812396
"77";"2021-03-17";"Salzburg";558410;67217;51566;15651;"2021-03-10";13248;2403;343,285714285714;375236;1093;"2024-03-14";0,0280277931985459
"78";"2021-03-17";"Steiermark";1246395;134596;97439;37157;"2021-03-10";34498;2659;379,857142857143;835319;2199;"2027-03-25";0,0298115765868766
"79";"2021-03-17";"Tirol";757634;134323;111897;22426;"2021-03-10";17162;5264;752;507918;675;"2023-01-21";0,0296000443485905
"80";"2021-03-17";"Vorarlberg";397139;61442;46172;15270;"2021-03-10";13345;1925;275;262727;955;"2023-10-28";0,0384500137231549
"81";"2021-03-17";"Wien";1911191;223381;164316;59065;"2021-03-10";53357;5708;815,428571428571;1278769;1568;"2025-07-02";0,0309048127581178
"82";"2021-03-16";"Burgenland";294436;39224;30812;8412;"2021-03-09";7263;1149;164,142857142857;197693;1204;"2024-07-02";0,0285698759662541
"83";"2021-03-16";"Kärnten";561293;79765;55466;24299;"2021-03-09";17440;6859;979,857142857143;368606;376;"2022-03-27";0,0432911153354843
"84";"2021-03-16";"Niederösterreich";1684287;207854;149578;58276;"2021-03-09";51060;7216;1030,85714285714;1120725;1087;"2024-03-07";0,0345998039526518
"85";"2021-03-16";"Oberösterreich";1490279;175010;128546;46464;"2021-03-09";44122;2342;334,571428571429;996731;2979;"2029-05-12";0,0311780545790419
"86";"2021-03-16";"Salzburg";558410;64401;49345;15056;"2021-03-09";13056;2000;285,714285714286;375831;1315;"2024-10-21";0,0269622678676958
"87";"2021-03-16";"Steiermark";1246395;133146;96274;36872;"2021-03-09";34168;2704;386,285714285714;835604;2163;"2027-02-16";0,0295829171330116
"88";"2021-03-16";"Tirol";757634;131647;110079;21568;"2021-03-09";16829;4739;677;508776;752;"2023-04-07";0,0284675714131098
"89";"2021-03-16";"Vorarlberg";397139;52110;38659;13451;"2021-03-09";13342;109;15,5714285714286;264546;16989;"2067-09-20";0,0338697534112741
"90";"2021-03-16";"Wien";1911191;217484;158879;58605;"2021-03-09";52689;5916;845,142857142857;1279229;1514;"2025-05-08";0,0306641251450012
"91";"2021-03-15";"Burgenland";294436;39029;30649;8380;"2021-03-08";7229;1151;164,428571428571;197725;1202;"2024-06-29";0,028461193604043
"92";"2021-03-15";"Kärnten";561293;76397;53135;23262;"2021-03-08";17164;6098;871,142857142857;369643;424;"2022-05-13";0,0414435954127345
"93";"2021-03-15";"Niederösterreich";1684287;200391;143720;56671;"2021-03-08";49694;6977;996,714285714286;1122330;1126;"2024-04-14";0,0336468784714244
"94";"2021-03-15";"Oberösterreich";1490279;171700;126817;44883;"2021-03-08";44001;882;126;998312;7923;"2042-11-23";0,0301171794006357
"95";"2021-03-15";"Salzburg";558410;61587;47155;14432;"2021-03-08";12876;1556;222,285714285714;376455;1694;"2025-11-03";0,0258448093694597
"96";"2021-03-15";"Steiermark";1246395;131918;95535;36383;"2021-03-08";33741;2642;377,428571428571;836093;2215;"2027-04-08";0,0291905856490117
"97";"2021-03-15";"Tirol";757634;126829;106033;20796;"2021-03-08";16078;4718;674;509548;756;"2023-04-10";0,0274486097508824
"98";"2021-03-15";"Vorarlberg";397139;52080;38638;13442;"2021-03-08";13342;100;14,2857142857143;264555;18519;"2071-11-27";0,0338470913206711
"99";"2021-03-15";"Wien";1911191;210750;152716;58034;"2021-03-08";52013;6021;860,142857142857;1279800;1488;"2025-04-11";0,0303653585643716
"100";"2021-03-14";"Burgenland";294436;38853;30505;8348;"2021-03-07";7183;1165;166,428571428571;197757;1188;"2024-06-14";0,0283525112418318
"101";"2021-03-14";"Kärnten";561293;75039;51961;23078;"2021-03-07";16501;6577;939,571428571429;369827;394;"2022-04-12";0,0411157808844935
"102";"2021-03-14";"Niederösterreich";1684287;194744;138753;55991;"2021-03-07";49034;6957;993,857142857143;1123010;1130;"2024-04-17";0,0332431468033655
"103";"2021-03-14";"Oberösterreich";1490279;169892;125204;44688;"2021-03-07";43920;768;109,714285714286;998507;9101;"2046-02-12";0,0299863314184794
"104";"2021-03-14";"Salzburg";558410;60093;45845;14248;"2021-03-07";12761;1487;212,428571428571;376639;1773;"2026-01-20";0,0255153023763901
"105";"2021-03-14";"Steiermark";1246395;130506;94455;36051;"2021-03-07";33539;2512;358,857142857143;836425;2331;"2027-08-01";0,0289242174431059
"106";"2021-03-14";"Tirol";757634;120907;100841;20066;"2021-03-07";15951;4115;587,857142857143;510278;868;"2023-07-30";0,0264850838267554
"107";"2021-03-14";"Vorarlberg";397139;52062;38620;13442;"2021-03-07";13341;101;14,4285714285714;264555;18335;"2071-05-26";0,0338470913206711
"108";"2021-03-14";"Wien";1911191;203235;146505;56730;"2021-03-07";51723;5007;715,285714285714;1281104;1791;"2026-02-07";0,0296830615045801
"109";"2021-03-13";"Burgenland";294436;36087;27739;8348;"2021-03-06";7181;1167;166,714285714286;197757;1186;"2024-06-11";0,0283525112418318
"110";"2021-03-13";"Kärnten";561293;69541;48518;21023;"2021-03-06";16497;4526;646,571428571429;371882;575;"2022-10-09";0,0374545914522362
"111";"2021-03-13";"Niederösterreich";1684287;193128;137422;55706;"2021-03-06";48680;7026;1003,71428571429;1123295;1119;"2024-04-05";0,0330739357366055
"112";"2021-03-13";"Oberösterreich";1490279;168854;124180;44674;"2021-03-06";43852;822;117,428571428571;998521;8503;"2044-06-23";0,0299769372043758
"113";"2021-03-13";"Salzburg";558410;59842;45619;14223;"2021-03-06";12748;1475;210,714285714286;376664;1788;"2026-02-03";0,0254705324045056
"114";"2021-03-13";"Steiermark";1246395;130346;94313;36033;"2021-03-06";33419;2614;373,428571428571;836443;2240;"2027-05-01";0,0289097757933881
"115";"2021-03-13";"Tirol";757634;108295;88270;20025;"2021-03-06";15923;4102;586;510319;871;"2023-08-01";0,0264309679871811
"116";"2021-03-13";"Vorarlberg";397139;52048;38607;13441;"2021-03-06";13074;367;52,4285714285714;264556;5046;"2035-01-05";0,0338445733106041
"117";"2021-03-13";"Wien";1911191;199970;143261;56709;"2021-03-06";51690;5019;717;1281125;1787;"2026-02-02";0,0296720735918074
"118";"2021-03-12";"Burgenland";294436;33038;24813;8225;"2021-03-05";7172;1053;150,428571428571;197880;1315;"2024-10-17";0,0279347634120828
"119";"2021-03-12";"Kärnten";561293;63854;44912;18942;"2021-03-05";16318;2624;374,857142857143;373963;998;"2023-12-05";0,0337470804018579
"120";"2021-03-12";"Niederösterreich";1684287;190441;135160;55281;"2021-03-05";47811;7470;1067,14285714286;1123720;1053;"2024-01-29";0,0328216034440686
"121";"2021-03-12";"Oberösterreich";1490279;164963;120361;44602;"2021-03-05";43804;798;114;998593;8760;"2045-03-06";0,0299286241032719
"122";"2021-03-12";"Salzburg";558410;58609;44436;14173;"2021-03-05";12744;1429;204,142857142857;376714;1845;"2026-03-31";0,0253809924607367
"123";"2021-03-12";"Steiermark";1246395;127831;92520;35311;"2021-03-05";33377;1934;276,285714285714;837165;3030;"2029-06-28";0,0283305051769303
"124";"2021-03-12";"Tirol";757634;91180;72207;18973;"2021-03-05";15860;3113;444,714285714286;511371;1150;"2024-05-05";0,0250424347376174
"125";"2021-03-12";"Vorarlberg";397139;52038;38597;13441;"2021-03-05";12086;1355;193,571428571429;264556;1367;"2024-12-08";0,0338445733106041
"126";"2021-03-12";"Wien";1911191;194551;138241;56310;"2021-03-05";51550;4760;680;1281524;1885;"2026-05-10";0,0294633032491258
"127";"2021-03-11";"Burgenland";294436;31937;23898;8039;"2021-03-04";7129;910;130;198066;1524;"2025-05-13";0,0273030471817305
"128";"2021-03-11";"Kärnten";561293;63242;44657;18585;"2021-03-04";16094;2491;355,857142857143;374320;1052;"2024-01-27";0,0331110489530424
"129";"2021-03-11";"Niederösterreich";1684287;180740;126535;54205;"2021-03-04";46436;7769;1109,85714285714;1124796;1013;"2023-12-19";0,0321827574516695
"130";"2021-03-11";"Oberösterreich";1490279;156207;111767;44440;"2021-03-04";43621;819;117;998755;8536;"2044-07-24";0,0298199196257882
"131";"2021-03-11";"Salzburg";558410;55554;41856;13698;"2021-03-04";12572;1126;160,857142857143;377189;2345;"2027-08-12";0,024530362994932
"132";"2021-03-11";"Steiermark";1246395;122856;88104;34752;"2021-03-04";32668;2084;297,714285714286;837724;2814;"2028-11-23";0,0278820117218057
"133";"2021-03-11";"Tirol";757634;73657;55594;18063;"2021-03-04";15732;2331;333;512281;1538;"2025-05-27";0,0238413270787742
"134";"2021-03-11";"Vorarlberg";397139;51750;38397;13353;"2021-03-04";12085;1268;181,142857142857;264644;1461;"2025-03-11";0,0336229884247077
"135";"2021-03-11";"Wien";1911191;185958;131363;54595;"2021-03-04";51001;3594;513,428571428571;1283239;2499;"2028-01-13";0,028565957039354
"136";"2021-03-10";"Burgenland";294436;30712;23430;7282;"2021-03-03";7227;55;7,85714285714286;198823;25305;"2090-06-21";0,0247320300506732
"137";"2021-03-10";"Kärnten";561293;62300;43997;18303;"2021-03-03";16018;2285;326,428571428571;374602;1148;"2024-05-01";0,032608637556499
"138";"2021-03-10";"Niederösterreich";1684287;174051;121368;52683;"2021-03-03";46306;6377;911;1126318;1236;"2024-07-28";0,0312791109828669
"139";"2021-03-10";"Oberösterreich";1490279;147309;103080;44229;"2021-03-03";44593;-364;-52;998966;NA;NA;0,0296783353989421
"140";"2021-03-10";"Salzburg";558410;53136;39888;13248;"2021-03-03";12628;620;88,5714285714286;377639;4264;"2032-11-11";0,0237245035010118
"141";"2021-03-10";"Steiermark";1246395;121292;86794;34498;"2021-03-03";32535;1963;280,428571428571;837978;2988;"2029-05-15";0,0276782239980103
"142";"2021-03-10";"Tirol";757634;63702;46540;17162;"2021-03-03";16258;904;129,142857142857;513182;3974;"2032-01-26";0,0226520985066668
"143";"2021-03-10";"Vorarlberg";397139;49604;36259;13345;"2021-03-03";12230;1115;159,285714285714;264652;1661;"2025-09-26";0,0336028443441717
"144";"2021-03-10";"Wien";1911191;178308;124951;53357;"2021-03-03";51743;1614;230,571428571429;1284477;5571;"2036-06-10";0,0279181934197053
"145";"2021-03-09";"Burgenland";294436;29996;22733;7263;"2021-03-02";7176;87;12,4285714285714;198842;15999;"2064-12-27";0,0246674998981103
"146";"2021-03-09";"Kärnten";561293;60944;43504;17440;"2021-03-02";15988;1452;207,428571428571;375465;1810;"2026-02-21";0,0310711161550206
"147";"2021-03-09";"Niederösterreich";1684287;167414;116354;51060;"2021-03-02";45060;6000;857,142857142857;1127941;1316;"2024-10-15";0,0303154984868968
"148";"2021-03-09";"Oberösterreich";1490279;141796;97674;44122;"2021-03-02";44526;-404;-57,7142857142857;999073;NA;NA;0,0296065367625794
"149";"2021-03-09";"Salzburg";558410;50666;37610;13056;"2021-03-02";12477;579;82,7142857142857;377831;4568;"2033-09-10";0,0233806701169392
"150";"2021-03-09";"Steiermark";1246395;119633;85465;34168;"2021-03-02";31694;2474;353,428571428571;838308;2372;"2027-09-06";0,0274134604198508
"151";"2021-03-09";"Tirol";757634;62407;45578;16829;"2021-03-02";16074;755;107,857142857143;513515;4761;"2034-03-22";0,0222125722974418
"152";"2021-03-09";"Vorarlberg";397139;49488;36146;13342;"2021-03-02";11980;1362;194,571428571429;264655;1360;"2024-11-28";0,0335952903139707
"153";"2021-03-09";"Wien";1911191;170768;118079;52689;"2021-03-02";51600;1089;155,571428571429;1285145;8261;"2043-10-21";0,0275686731467446
"154";"2021-03-08";"Burgenland";294436;28759;21530;7229;"2021-03-01";7107;122;17,4285714285714;198876;11411;"2052-06-04";0,0245520248882609
"155";"2021-03-08";"Kärnten";561293;60309;43145;17164;"2021-03-01";15527;1637;233,857142857143;375741;1607;"2025-08-01";0,0305793943626591
"156";"2021-03-08";"Niederösterreich";1684287;161261;111567;49694;"2021-03-01";43662;6032;861,714285714286;1129307;1311;"2024-10-09";0,0295044728125314
"157";"2021-03-08";"Oberösterreich";1490279;135808;91807;44001;"2021-03-01";44421;-420;-60;999194;NA;NA;0,0295253439121131
"158";"2021-03-08";"Salzburg";558410;47913;35037;12876;"2021-03-01";12392;484;69,1428571428571;378011;5467;"2036-02-25";0,0230583263193711
"159";"2021-03-08";"Steiermark";1246395;117337;83596;33741;"2021-03-01";31166;2575;367,857142857143;838735;2280;"2027-06-05";0,02707087239599
"160";"2021-03-08";"Tirol";757634;60064;43986;16078;"2021-03-01";15784;294;42;514266;12244;"2054-09-15";0,0212213285042646
"161";"2021-03-08";"Vorarlberg";397139;49298;35956;13342;"2021-03-01";11979;1363;194,714285714286;264655;1359;"2024-11-26";0,0335952903139707
"162";"2021-03-08";"Wien";1911191;163152;111139;52013;"2021-03-01";51416;597;85,2857142857143;1285821;15077;"2062-06-18";0,0272149670022515
"163";"2021-03-07";"Burgenland";294436;28597;21414;7183;"2021-02-28";6967;216;30,8571428571429;198922;6447;"2038-10-31";0,0243957939925824
"164";"2021-03-07";"Kärnten";561293;59579;43078;16501;"2021-02-28";15170;1331;190,142857142857;376404;1980;"2026-08-08";0,0293981931005731
"165";"2021-03-07";"Niederösterreich";1684287;158527;109493;49034;"2021-02-28";43174;5860;837,142857142857;1129967;1350;"2024-11-16";0,0291126156052977
"166";"2021-03-07";"Oberösterreich";1490279;133731;89811;43920;"2021-02-28";44290;-370;-52,8571428571429;999275;NA;NA;0,0294709916733712
"167";"2021-03-07";"Salzburg";558410;47365;34604;12761;"2021-02-28";12112;649;92,7142857142857;378126;4078;"2032-05-06";0,0228523844487026
"168";"2021-03-07";"Steiermark";1246395;115687;82148;33539;"2021-02-28";30235;3304;472;838937;1777;"2026-01-17";0,0269088049936015
"169";"2021-03-07";"Tirol";757634;59321;43370;15951;"2021-02-28";15401;550;78,5714285714286;514393;6547;"2039-02-08";0,021053701391437
"170";"2021-03-07";"Vorarlberg";397139;49288;35947;13341;"2021-02-28";11650;1691;241,571428571429;264656;1096;"2024-03-07";0,0335927723039037
"171";"2021-03-07";"Wien";1911191;156728;105005;51723;"2021-02-28";51063;660;94,2857142857143;1286111;13641;"2058-07-12";0,0270632291591997
"172";"2021-03-06";"Burgenland";294436;28550;21369;7181;"2021-02-27";6966;215;30,7142857142857;198924;6477;"2038-11-29";0,0243890013449442
"173";"2021-03-06";"Kärnten";561293;57828;41331;16497;"2021-02-27";15168;1329;189,857142857143;376408;1983;"2026-08-10";0,0293910666977853
"174";"2021-03-06";"Niederösterreich";1684287;157212;108532;48680;"2021-02-27";42941;5739;819,857142857143;1130321;1379;"2024-12-14";0,0289024376486905
"175";"2021-03-06";"Oberösterreich";1490279;133376;89524;43852;"2021-02-27";44185;-333;-47,5714285714286;999343;NA;NA;0,0294253626334398
"176";"2021-03-06";"Salzburg";558410;47298;34550;12748;"2021-02-27";12097;651;93;378139;4066;"2032-04-23";0,0228291040633226
"177";"2021-03-06";"Steiermark";1246395;114934;81515;33419;"2021-02-27";30189;3230;461,428571428571;839057;1818;"2026-02-26";0,0268125273288163
"178";"2021-03-06";"Tirol";757634;58848;42925;15923;"2021-02-27";15343;580;82,8571428571429;514421;6209;"2038-03-06";0,0210167442327034
"179";"2021-03-06";"Vorarlberg";397139;45546;32472;13074;"2021-02-27";11633;1441;205,857142857143;264923;1287;"2024-09-13";0,0329204636160135
"180";"2021-03-06";"Wien";1911191;152841;101151;51690;"2021-02-27";51032;658;94;1286144;13682;"2058-08-21";0,0270459624391283
"181";"2021-03-05";"Burgenland";294436;26307;19135;7172;"2021-02-26";6933;239;34,1428571428571;198933;5826;"2037-02-15";0,0243584344305723
"182";"2021-03-05";"Kärnten";561293;53868;37550;16318;"2021-02-26";15088;1230;175,714285714286;376587;2143;"2027-01-16";0,0290721601730291
"183";"2021-03-05";"Niederösterreich";1684287;154693;106882;47811;"2021-02-26";41783;6028;861,142857142857;1131190;1314;"2024-10-09";0,0283864923258328
"184";"2021-03-05";"Oberösterreich";1490279;130195;86391;43804;"2021-02-26";43963;-159;-22,7142857142857;999391;NA;NA;0,0293931538993705
"185";"2021-03-05";"Salzburg";558410;47057;34313;12744;"2021-02-26";12073;671;95,8571428571429;378143;3945;"2031-12-23";0,0228219408678211
"186";"2021-03-05";"Steiermark";1246395;111731;78354;33377;"2021-02-26";30078;3299;471,285714285714;839099;1780;"2026-01-18";0,0267788301461415
"187";"2021-03-05";"Tirol";757634;57883;42023;15860;"2021-02-26";15152;708;101,142857142857;514484;5087;"2035-02-07";0,0209335906255527
"188";"2021-03-05";"Vorarlberg";397139;41742;29656;12086;"2021-02-26";11526;560;80;265911;3324;"2030-04-11";0,0304326696698133
"189";"2021-03-05";"Wien";1911191;147336;95786;51550;"2021-02-26";50734;816;116,571428571429;1286284;11034;"2051-05-21";0,0269727096873102
"190";"2021-03-04";"Burgenland";294436;25601;18472;7129;"2021-02-25";6807;322;46;198976;4326;"2033-01-06";0,0242123925063511
"191";"2021-03-04";"Kärnten";561293;53418;37324;16094;"2021-02-25";14551;1543;220,428571428571;376811;1709;"2025-11-07";0,0286730816169095
"192";"2021-03-04";"Niederösterreich";1684287;146905;100469;46436;"2021-02-25";39470;6966;995,142857142857;1132565;1138;"2024-04-15";0,027570123144096
"193";"2021-03-04";"Oberösterreich";1490279;123727;80106;43621;"2021-02-25";42167;1454;207,714285714286;999574;4812;"2034-05-07";0,0292703581007315
"194";"2021-03-04";"Salzburg";558410;44812;32240;12572;"2021-02-25";11409;1163;166,142857142857;378315;2277;"2027-05-29";0,0225139234612561
"195";"2021-03-04";"Steiermark";1246395;105693;73025;32668;"2021-02-25";24082;8586;1226,57142857143;839808;685;"2023-01-18";0,0262099896100353
"196";"2021-03-04";"Tirol";757634;55678;39946;15732;"2021-02-25";13806;1926;275,142857142857;514612;1870;"2026-04-17";0,0207646436141989
"197";"2021-03-04";"Vorarlberg";397139;38088;26003;12085;"2021-02-25";10101;1984;283,428571428571;265912;938;"2023-09-28";0,0304301516597463
"198";"2021-03-04";"Wien";1911191;142254;91253;51001;"2021-02-25";49504;1497;213,857142857143;1286833;6017;"2037-08-24";0,0266854542533949
"199";"2021-03-03";"Burgenland";294436;24432;17205;7227;"2021-02-24";6750;477;68,1428571428571;198878;2919;"2029-02-28";0,0245452322406228
"200";"2021-03-03";"Kärnten";561293;52668;36650;16018;"2021-02-24";14222;1796;256,571428571429;376887;1469;"2025-03-11";0,0285376799639404
"201";"2021-03-03";"Niederösterreich";1684287;142668;96362;46306;"2021-02-24";38119;8187;1169,57142857143;1132695;968;"2023-10-27";0,0274929391487318
"202";"2021-03-03";"Oberösterreich";1490279;122101;77508;44593;"2021-02-24";41145;3448;492,571428571429;998602;2027;"2026-09-20";0,029922584965634
"203";"2021-03-03";"Salzburg";558410;42453;29825;12628;"2021-02-24";11245;1383;197,571428571429;378259;1915;"2026-05-31";0,0226142081982773
"204";"2021-03-03";"Steiermark";1246395;100138;67603;32535;"2021-02-24";23114;9421;1345,85714285714;839941;624;"2022-11-17";0,0261032818648984
"205";"2021-03-03";"Tirol";757634;54871;38613;16258;"2021-02-24";13540;2718;388,285714285714;514086;1324;"2024-10-17";0,0214589102389808
"206";"2021-03-03";"Vorarlberg";397139;38010;25780;12230;"2021-02-24";10043;2187;312,428571428571;265767;851;"2023-07-02";0,030795263119462
"207";"2021-03-03";"Wien";1911191;139474;87731;51743;"2021-02-24";48970;2773;396,142857142857;1286091;3247;"2030-01-22";0,0270736938380308
"208";"2021-03-02";"Burgenland";294436;23414;16238;7176;"2021-02-23";6670;506;72,2857142857143;198929;2752;"2028-09-13";0,0243720197258487
"209";"2021-03-02";"Kärnten";561293;52048;36060;15988;"2021-02-23";14007;1981;283;376917;1332;"2024-10-24";0,0284842319430315
"210";"2021-03-02";"Niederösterreich";1684287;136517;91457;45060;"2021-02-23";36468;8592;1227,42857142857;1133941;924;"2023-09-12";0,0267531602393179
"211";"2021-03-02";"Oberösterreich";1490279;119300;74774;44526;"2021-02-23";40160;4366;623,714285714286;998669;1601;"2025-07-20";0,0298776269409956
"212";"2021-03-02";"Salzburg";558410;39791;27314;12477;"2021-02-23";11075;1402;200,285714285714;378410;1889;"2026-05-04";0,0223437975680951
"213";"2021-03-02";"Steiermark";1246395;92431;60737;31694;"2021-02-23";22023;9671;1381,57142857143;840782;609;"2022-11-01";0,0254285358975285
"214";"2021-03-02";"Tirol";757634;52936;36862;16074;"2021-02-23";12870;3204;457,714285714286;514270;1124;"2024-03-30";0,0212160489101598
"215";"2021-03-02";"Vorarlberg";397139;37220;25240;11980;"2021-02-23";10024;1956;279,428571428571;266017;952;"2023-10-10";0,0301657606027109
"216";"2021-03-02";"Wien";1911191;135878;84278;51600;"2021-02-23";48551;3049;435,571428571429;1286234;2953;"2029-04-02";0,0269988713843881
"217";"2021-03-01";"Burgenland";294436;23112;16005;7107;"2021-02-22";6624;483;69;198998;2884;"2029-01-22";0,024137673382331
"218";"2021-03-01";"Kärnten";561293;50857;35330;15527;"2021-02-22";14001;1526;218;377378;1731;"2025-11-26";0,027662914021732
"219";"2021-03-01";"Niederösterreich";1684287;130936;87274;43662;"2021-02-22";35612;8050;1150;1135339;987;"2023-11-13";0,025923135427632
"220";"2021-03-01";"Oberösterreich";1490279;117033;72612;44421;"2021-02-22";39620;4801;685,857142857143;998774;1456;"2025-02-24";0,0298071703352191
"221";"2021-03-01";"Salzburg";558410;37190;24798;12392;"2021-02-22";10907;1485;212,142857142857;378495;1784;"2026-01-18";0,022191579663688
"222";"2021-03-01";"Steiermark";1246395;83749;52583;31166;"2021-02-22";21178;9988;1426,85714285714;841310;590;"2022-10-12";0,0250049141724734
"223";"2021-03-01";"Tirol";757634;51146;35362;15784;"2021-02-22";12089;3695;527,857142857143;514560;975;"2023-11-01";0,0208332783375614
"224";"2021-03-01";"Vorarlberg";397139;37212;25233;11979;"2021-02-22";10024;1955;279,285714285714;266018;952;"2023-10-09";0,0301632425926439
"225";"2021-03-01";"Wien";1911191;133138;81722;51416;"2021-02-22";47886;3530;504,285714285714;1286418;2551;"2028-02-24";0,0269025963391414
"226";"2021-02-28";"Burgenland";294436;22861;15894;6967;"2021-02-21";6598;369;52,7142857142857;199138;3778;"2031-07-04";0,0236621880476572
"227";"2021-02-28";"Kärnten";561293;50106;34936;15170;"2021-02-21";13909;1261;180,142857142857;377735;2097;"2026-11-26";0,0270268825729165
"228";"2021-02-28";"Niederösterreich";1684287;128136;84962;43174;"2021-02-21";35175;7999;1142,71428571429;1135827;994;"2023-11-19";0,0256333985834956
"229";"2021-02-28";"Oberösterreich";1490279;115977;71687;44290;"2021-02-21";39299;4991;713;998905;1401;"2024-12-30";0,0297192673318218
"230";"2021-02-28";"Salzburg";558410;36000;23888;12112;"2021-02-21";10902;1210;172,857142857143;378775;2191;"2027-02-28";0,021690155978582
"231";"2021-02-28";"Steiermark";1246395;81147;50912;30235;"2021-02-21";21066;9169;1309,85714285714;842241;643;"2022-12-03";0,0242579599565146
"232";"2021-02-28";"Tirol";757634;49979;34578;15401;"2021-02-21";11999;3402;486;514943;1060;"2024-01-24";0,0203277572020263
"233";"2021-02-28";"Vorarlberg";397139;36728;25078;11650;"2021-02-21";9975;1675;239,285714285714;266347;1113;"2024-03-17";0,0293348172805995
"234";"2021-02-28";"Wien";1911191;130017;78954;51063;"2021-02-21";46616;4447;635,285714285714;1286771;2025;"2026-09-15";0,0267178947577715
"235";"2021-02-27";"Burgenland";294436;22817;15851;6966;"2021-02-20";6591;375;53,5714285714286;199139;3717;"2031-05-03";0,0236587917238381
"236";"2021-02-27";"Kärnten";561293;49785;34617;15168;"2021-02-20";13895;1273;181,857142857143;377737;2077;"2026-11-05";0,0270233193715225
"237";"2021-02-27";"Niederösterreich";1684287;126029;83088;42941;"2021-02-20";34919;8022;1146;1136060;991;"2023-11-15";0,0254950611148813
"238";"2021-02-27";"Oberösterreich";1490279;115280;71095;44185;"2021-02-20";38213;5972;853,142857142857;999010;1171;"2024-05-13";0,0296488107260453
"239";"2021-02-27";"Salzburg";558410;35905;23808;12097;"2021-02-20";10841;1256;179,428571428571;378790;2111;"2026-12-09";0,0216632939954514
"240";"2021-02-27";"Steiermark";1246395;79455;49266;30189;"2021-02-20";20971;9218;1316,85714285714;842287;640;"2022-11-29";0,0242210535183469
"241";"2021-02-27";"Tirol";757634;49218;33875;15343;"2021-02-20";11736;3607;515,285714285714;515001;999;"2023-11-23";0,0202512030875066
"242";"2021-02-27";"Vorarlberg";397139;34368;22735;11633;"2021-02-20";9872;1761;251,571428571429;266364;1059;"2024-01-22";0,0292920111094604
"243";"2021-02-27";"Wien";1911191;127471;76439;51032;"2021-02-20";46582;4450;635,714285714286;1286802;2024;"2026-09-13";0,0267016745055832
"244";"2021-02-26";"Burgenland";294436;21177;14244;6933;"2021-02-19";6446;487;69,5714285714286;199172;2863;"2028-12-29";0,0235467130378079
"245";"2021-02-26";"Kärnten";561293;46590;31502;15088;"2021-02-19";13358;1730;247,142857142857;377817;1529;"2025-05-05";0,0268807913157656
"246";"2021-02-26";"Niederösterreich";1684287;122588;80805;41783;"2021-02-19";33887;7896;1128;1137218;1008;"2023-12-01";0,0248075298330985
"247";"2021-02-26";"Oberösterreich";1490279;112174;68211;43963;"2021-02-19";34482;9481;1354,42857142857;999232;738;"2023-03-06";0,0294998453309749
"248";"2021-02-26";"Salzburg";558410;35237;23164;12073;"2021-02-19";10635;1438;205,428571428571;378814;1844;"2026-03-16";0,0216203148224423
"249";"2021-02-26";"Steiermark";1246395;74809;44731;30078;"2021-02-19";20129;9949;1421,28571428571;842398;593;"2022-10-12";0,0241319966784206
"250";"2021-02-26";"Tirol";757634;45654;30502;15152;"2021-02-19";11412;3740;534,285714285714;515192;964;"2023-10-18";0,0199991024690022
"251";"2021-02-26";"Vorarlberg";397139;32144;20618;11526;"2021-02-19";9705;1821;260,142857142857;266471;1024;"2023-12-17";0,029022584032291
"252";"2021-02-26";"Wien";1911191;125039;74305;50734;"2021-02-19";44312;6422;917,428571428571;1287100;1403;"2024-12-30";0,0265457507909989
"253";"2021-02-25";"Burgenland";294436;19242;12435;6807;"2021-02-18";6287;520;74,2857142857143;199298;2683;"2028-07-01";0,0231187762366015
"254";"2021-02-25";"Kärnten";561293;44245;29694;14551;"2021-02-18";13060;1491;213;378354;1776;"2026-01-06";0,0259240717414969
"255";"2021-02-25";"Niederösterreich";1684287;112431;72961;39470;"2021-02-18";32172;7298;1042,57142857143;1139531;1093;"2024-02-23";0,0234342484386568
"256";"2021-02-25";"Oberösterreich";1490279;100358;58191;42167;"2021-02-18";32011;10156;1450,85714285714;1001028;690;"2023-01-16";0,0282947018645502
"257";"2021-02-25";"Salzburg";558410;31292;19883;11409;"2021-02-18";10356;1053;150,428571428571;379478;2523;"2028-01-23";0,0204312243691911
"258";"2021-02-25";"Steiermark";1246395;56743;32661;24082;"2021-02-18";18590;5492;784,571428571429;848394;1081;"2024-02-11";0,0193213226946514
"259";"2021-02-25";"Tirol";757634;41591;27785;13806;"2021-02-18";11024;2782;397,428571428571;516538;1300;"2024-09-17";0,0182225190527352
"260";"2021-02-25";"Vorarlberg";397139;27151;17050;10101;"2021-02-18";9293;808;115,428571428571;267896;2321;"2027-07-05";0,0254344196868099
"261";"2021-02-25";"Wien";1911191;118314;68810;49504;"2021-02-18";41557;7947;1135,28571428571;1288330;1135;"2024-04-05";0,0259021730428827
"262";"2021-02-24";"Burgenland";294436;18085;11335;6750;"2021-02-17";5873;877;125,285714285714;199355;1591;"2025-07-04";0,0229251857789129
"263";"2021-02-24";"Kärnten";561293;42813;28591;14222;"2021-02-17";12801;1421;203;378683;1865;"2026-04-04";0,0253379251121963
"264";"2021-02-24";"Niederösterreich";1684287;107155;69036;38119;"2021-02-17";30282;7837;1119,57142857143;1140882;1019;"2023-12-10";0,0226321286099103
"265";"2021-02-24";"Oberösterreich";1490279;97551;56406;41145;"2021-02-17";29652;11493;1641,85714285714;1002050;610;"2022-10-27";0,0276089242349922
"266";"2021-02-24";"Salzburg";558410;30158;18913;11245;"2021-02-17";10047;1198;171,142857142857;379642;2218;"2027-03-23";0,0201375333536291
"267";"2021-02-24";"Steiermark";1246395;54359;31245;23114;"2021-02-17";17239;5875;839,285714285714;849362;1012;"2023-12-03";0,0185446828653838
"268";"2021-02-24";"Tirol";757634;39278;25738;13540;"2021-02-17";10532;3008;429,714285714286;516804;1203;"2024-06-11";0,0178714260447657
"269";"2021-02-24";"Vorarlberg";397139;26999;16956;10043;"2021-02-17";8618;1425;203,571428571429;267954;1316;"2024-10-02";0,0252883751029237
"270";"2021-02-24";"Wien";1911191;114466;65496;48970;"2021-02-17";35050;13920;1988,57142857143;1288864;648;"2022-12-04";0,0256227661180908
"271";"2021-02-23";"Burgenland";294436;17828;11158;6670;"2021-02-16";5505;1165;166,428571428571;199435;1198;"2024-06-05";0,022653479873385
"272";"2021-02-23";"Kärnten";561293;42023;28016;14007;"2021-02-16";12722;1285;183,571428571429;378898;2064;"2026-10-19";0,0249548809623494
"273";"2021-02-23";"Niederösterreich";1684287;103122;66654;36468;"2021-02-16";28989;7479;1068,42857142857;1142533;1069;"2024-01-28";0,0216518918687848
"274";"2021-02-23";"Oberösterreich";1490279;94352;54192;40160;"2021-02-16";27761;12399;1771,28571428571;1003035;566;"2022-09-12";0,0269479741712793
"275";"2021-02-23";"Salzburg";558410;28585;17510;11075;"2021-02-16";9477;1598;228,285714285714;379812;1664;"2025-09-14";0,0198330975448147
"276";"2021-02-23";"Steiermark";1246395;51958;29935;22023;"2021-02-16";15904;6119;874,142857142857;850453;973;"2023-10-24";0,0176693584297113
"277";"2021-02-23";"Tirol";757634;36567;23697;12870;"2021-02-16";9898;2972;424,571428571429;517474;1219;"2024-06-26";0,0169870940322108
"278";"2021-02-23";"Vorarlberg";397139;26967;16943;10024;"2021-02-16";8308;1716;245,142857142857;267973;1093;"2024-02-21";0,0252405329116506
"279";"2021-02-23";"Wien";1911191;113070;64519;48551;"2021-02-16";32913;15638;2234;1289283;577;"2022-09-23";0,025403531096578
"280";"2021-02-22";"Burgenland";294436;17675;11051;6624;"2021-02-15";5419;1205;172,142857142857;199481;1159;"2024-04-26";0,0224972489777065
"281";"2021-02-22";"Kärnten";561293;41726;27725;14001;"2021-02-15";12708;1293;184,714285714286;378904;2051;"2026-10-05";0,0249441913581677
"282";"2021-02-22";"Niederösterreich";1684287;100825;65213;35612;"2021-02-15";28375;7237;1033,85714285714;1143389;1106;"2024-03-04";0,0211436649454636
"283";"2021-02-22";"Oberösterreich";1490279;92403;52783;39620;"2021-02-15";24556;15064;2152;1003575;466;"2022-06-03";0,0265856259130002
"284";"2021-02-22";"Salzburg";558410;27435;16528;10907;"2021-02-15";8889;2018;288,285714285714;379980;1318;"2024-10-02";0,0195322433337512
"285";"2021-02-22";"Steiermark";1246395;49940;28762;21178;"2021-02-15";14606;6572;938,857142857143;851298;907;"2023-08-18";0,0169914032068486
"286";"2021-02-22";"Tirol";757634;34800;22711;12089;"2021-02-15";9520;2569;367;518255;1412;"2025-01-04";0,0159562532832476
"287";"2021-02-22";"Vorarlberg";397139;26908;16884;10024;"2021-02-15";8044;1980;282,857142857143;267973;947;"2023-09-27";0,0252405329116506
"288";"2021-02-22";"Wien";1911191;111562;63676;47886;"2021-02-15";31772;16114;2302;1289948;560;"2022-09-05";0,025055580525442
"289";"2021-02-21";"Burgenland";294436;17565;10967;6598;"2021-02-14";5357;1241;177,285714285714;199507;1125;"2024-03-22";0,02240894455841
"290";"2021-02-21";"Kärnten";561293;38819;24910;13909;"2021-02-14";12002;1907;272,428571428571;378996;1391;"2024-12-13";0,0247802840940471
"291";"2021-02-21";"Niederösterreich";1684287;99747;64572;35175;"2021-02-14";28288;6887;983,857142857143;1143826;1163;"2024-04-29";0,0208842079764316
"292";"2021-02-21";"Oberösterreich";1490279;91950;52651;39299;"2021-02-14";24122;15177;2168,14285714286;1003896;463;"2022-05-30";0,026370230003912
"293";"2021-02-21";"Salzburg";558410;27124;16222;10902;"2021-02-14";8886;2016;288;379985;1319;"2024-10-02";0,0195232893393743
"294";"2021-02-21";"Steiermark";1246395;49392;28326;21066;"2021-02-14";14411;6655;950,714285714286;851410;896;"2023-08-06";0,016901544053049
"295";"2021-02-21";"Tirol";757634;34588;22589;11999;"2021-02-14";9343;2656;379,428571428571;518345;1366;"2024-11-18";0,0158374624158895
"296";"2021-02-21";"Vorarlberg";397139;25124;15149;9975;"2021-02-14";7791;2184;312;268022;859;"2023-06-30";0,0251171504183674
"297";"2021-02-21";"Wien";1911191;109429;62813;46616;"2021-02-14";31722;14894;2127,71428571429;1291218;607;"2022-10-21";0,0243910734196634
"298";"2021-02-20";"Burgenland";294436;16474;9883;6591;"2021-02-13";5331;1260;180;199514;1108;"2024-03-04";0,0223851702916763
"299";"2021-02-20";"Kärnten";561293;35677;21782;13895;"2021-02-13";10919;2976;425,142857142857;379010;891;"2023-07-31";0,0247553416842897
"300";"2021-02-20";"Niederösterreich";1684287;98780;63861;34919;"2021-02-13";27992;6927;989,571428571429;1144082;1156;"2024-04-21";0,0207322148778682
"301";"2021-02-20";"Oberösterreich";1490279;90785;52572;38213;"2021-02-13";22684;15529;2218,42857142857;1004982;453;"2022-05-19";0,0256415073955951
"302";"2021-02-20";"Salzburg";558410;26477;15636;10841;"2021-02-13";8690;2151;307,285714285714;380046;1237;"2024-07-11";0,0194140506079762
"303";"2021-02-20";"Steiermark";1246395;48659;27688;20971;"2021-02-13";14010;6961;994,428571428571;851505;856;"2023-06-26";0,016825324235094
"304";"2021-02-20";"Tirol";757634;33105;21369;11736;"2021-02-13";9019;2717;388,142857142857;518608;1336;"2024-10-18";0,0154903291034985
"305";"2021-02-20";"Vorarlberg";397139;23486;13614;9872;"2021-02-13";6491;3381;483;268125;555;"2022-08-29";0,0248577953814659
"306";"2021-02-20";"Wien";1911191;108778;62196;46582;"2021-02-13";31428;15154;2164,85714285714;1291252;596;"2022-10-09";0,0243732834656505
"307";"2021-02-19";"Burgenland";294436;15941;9495;6446;"2021-02-12";5029;1417;202,428571428571;199659;986;"2023-11-02";0,021892703337907
"308";"2021-02-19";"Kärnten";561293;34563;21205;13358;"2021-02-12";10672;2686;383,714285714286;379547;989;"2023-11-05";0,023798622110021
"309";"2021-02-19";"Niederösterreich";1684287;95388;61501;33887;"2021-02-12";26182;7705;1100,71428571429;1145114;1040;"2023-12-26";0,0201194926992846
"310";"2021-02-19";"Oberösterreich";1490279;86273;51791;34482;"2021-02-12";17116;17366;2480,85714285714;1008713;407;"2022-04-02";0,0231379493370033
"311";"2021-02-19";"Salzburg";558410;24648;14013;10635;"2021-02-12";8107;2528;361,142857142857;380252;1053;"2024-01-08";0,0190451460396483
"312";"2021-02-19";"Steiermark";1246395;46489;26360;20129;"2021-02-12";12775;7354;1050,57142857143;852347;811;"2023-05-11";0,0161497759538509
"313";"2021-02-19";"Tirol";757634;31866;20454;11412;"2021-02-12";8539;2873;410,428571428571;518932;1264;"2024-08-06";0,0150626819810093
"314";"2021-02-19";"Vorarlberg";397139;21423;11718;9705;"2021-02-12";5684;4021;574,428571428571;268292;467;"2022-06-01";0,0244372877002762
"315";"2021-02-19";"Wien";1911191;104979;60667;44312;"2021-02-12";28245;16067;2295,28571428571;1293522;564;"2022-09-06";0,023185542418314
"316";"2021-02-18";"Burgenland";294436;14565;8278;6287;"2021-02-11";4655;1632;233,142857142857;199818;857;"2023-06-25";0,0213526878506704
"317";"2021-02-18";"Kärnten";561293;33680;20620;13060;"2021-02-11";9991;3069;438,428571428571;379845;866;"2023-07-04";0,0232677051023262
"318";"2021-02-18";"Niederösterreich";1684287;91189;59017;32172;"2021-02-11";22768;9404;1343,42857142857;1146829;854;"2023-06-22";0,0191012576835183
"319";"2021-02-18";"Oberösterreich";1490279;82500;50489;32011;"2021-02-11";14434;17577;2511;1011184;403;"2022-03-28";0,0214798705477297
"320";"2021-02-18";"Salzburg";558410;23552;13196;10356;"2021-02-11";7342;3014;430,571428571429;380531;884;"2023-07-22";0,0185455131534177
"321";"2021-02-18";"Steiermark";1246395;44270;25680;18590;"2021-02-11";10506;8084;1154,85714285714;853886;739;"2023-02-27";0,0149150149029802
"322";"2021-02-18";"Tirol";757634;29623;18599;11024;"2021-02-11";7842;3182;454,571428571429;519320;1142;"2024-04-05";0,0145505613528432
"323";"2021-02-18";"Vorarlberg";397139;21008;11715;9293;"2021-02-11";5145;4148;592,571428571429;268704;453;"2022-05-17";0,0233998675526705
"324";"2021-02-18";"Wien";1911191;100154;58597;41557;"2021-02-11";23767;17790;2541,42857142857;1296277;510;"2022-07-13";0,021744032909322
"325";"2021-02-17";"Burgenland";294436;14044;8171;5873;"2021-02-10";3878;1995;285;200232;703;"2023-01-21";0,0199466097895638
"326";"2021-02-17";"Kärnten";561293;32057;19256;12801;"2021-02-10";8998;3803;543,285714285714;380104;700;"2023-01-18";0,022806270521813
"327";"2021-02-17";"Niederösterreich";1684287;85654;55372;30282;"2021-02-10";18638;11644;1663,42857142857;1148719;691;"2023-01-09";0,0179791211355309
"328";"2021-02-17";"Oberösterreich";1490279;79340;49688;29652;"2021-02-10";12807;16845;2406,42857142857;1013543;421;"2022-04-14";0,0198969454712842
"329";"2021-02-17";"Salzburg";558410;22919;12872;10047;"2021-02-10";6245;3802;543,142857142857;380840;701;"2023-01-19";0,0179921563009258
"330";"2021-02-17";"Steiermark";1246395;42471;25232;17239;"2021-02-10";8699;8540;1220;855237;701;"2023-01-19";0,013831088860273
"331";"2021-02-17";"Tirol";757634;27782;17250;10532;"2021-02-10";6528;4004;572;519812;909;"2023-08-15";0,0139011712779522
"332";"2021-02-17";"Vorarlberg";397139;20326;11708;8618;"2021-02-10";4255;4363;623,285714285714;269379;432;"2022-04-25";0,0217002107574426
"333";"2021-02-17";"Wien";1911191;89355;54305;35050;"2021-02-10";20935;14115;2016,42857142857;1302784;646;"2022-11-25";0,0183393496516047
"334";"2021-02-16";"Burgenland";294436;13574;8069;5505;"2021-02-09";2592;2913;416,142857142857;200600;482;"2022-06-13";0,0186967626241356
"335";"2021-02-16";"Kärnten";561293;30855;18133;12722;"2021-02-09";8135;4587;655,285714285714;380183;580;"2022-09-19";0,022665524066753
"336";"2021-02-16";"Niederösterreich";1684287;82676;53687;28989;"2021-02-09";16524;12465;1780,71428571429;1150012;646;"2022-11-24";0,0172114372431777
"337";"2021-02-16";"Oberösterreich";1490279;76819;49058;27761;"2021-02-09";11095;16666;2380,85714285714;1015434;426;"2022-04-18";0,0186280555520141
"338";"2021-02-16";"Salzburg";558410;21821;12344;9477;"2021-02-09";5232;4245;606,428571428571;381410;629;"2022-11-07";0,0169714009419602
"339";"2021-02-16";"Steiermark";1246395;40324;24420;15904;"2021-02-09";6733;9171;1310,14285714286;856572;654;"2022-12-02";0,0127599998395372
"340";"2021-02-16";"Tirol";757634;26411;16513;9898;"2021-02-09";5514;4384;626,285714285714;520446;831;"2023-05-28";0,0130643556123405
"341";"2021-02-16";"Vorarlberg";397139;20014;11706;8308;"2021-02-09";4091;4217;602,428571428571;269689;448;"2022-05-10";0,0209196276366713
"342";"2021-02-16";"Wien";1911191;86536;53623;32913;"2021-02-09";18936;13977;1996,71428571429;1304921;654;"2022-12-02";0,0172211987184954
"343";"2021-02-15";"Burgenland";294436;13429;8010;5419;"2021-02-08";2359;3060;437,142857142857;200686;459;"2022-05-20";0,0184046787756932
"344";"2021-02-15";"Kärnten";561293;30344;17636;12708;"2021-02-08";8008;4700;671,428571428571;380197;566;"2022-09-04";0,0226405816569955
"345";"2021-02-15";"Niederösterreich";1684287;81204;52829;28375;"2021-02-08";15404;12971;1853;1150626;621;"2022-10-29";0,0168468912958421
"346";"2021-02-15";"Oberösterreich";1490279;72315;47759;24556;"2021-02-08";10805;13751;1964,42857142857;1018639;519;"2022-07-19";0,016477451537598
"347";"2021-02-15";"Salzburg";558410;20809;11920;8889;"2021-02-08";4720;4169;595,571428571429;381998;641;"2022-11-18";0,0159184112032378
"348";"2021-02-15";"Steiermark";1246395;38414;23808;14606;"2021-02-08";5569;9037;1291;857870;665;"2022-12-12";0,0117185964321102
"349";"2021-02-15";"Tirol";757634;25839;16319;9520;"2021-02-08";5049;4471;638,714285714286;520824;815;"2023-05-11";0,0125654339694364
"350";"2021-02-15";"Vorarlberg";397139;19742;11698;8044;"2021-02-08";3960;4084;583,428571428571;269953;463;"2022-05-24";0,0202548729789822
"351";"2021-02-15";"Wien";1911191;84418;52646;31772;"2021-02-08";15261;16511;2358,71428571429;1306062;554;"2022-08-23";0,0166241887911779
"352";"2021-02-14";"Burgenland";294436;13320;7963;5357;"2021-02-07";2253;3104;443,428571428571;200748;453;"2022-05-13";0,0181941066989091
"353";"2021-02-14";"Kärnten";561293;29610;17608;12002;"2021-02-07";7314;4688;669,714285714286;380903;569;"2022-09-06";0,0213827715649402
"354";"2021-02-14";"Niederösterreich";1684287;80912;52624;28288;"2021-02-07";14954;13334;1904,85714285714;1150713;604;"2022-10-11";0,0167952373912522
"355";"2021-02-14";"Oberösterreich";1490279;71673;47551;24122;"2021-02-07";10770;13352;1907,42857142857;1019073;534;"2022-08-02";0,0161862309003885
"356";"2021-02-14";"Salzburg";558410;20711;11825;8886;"2021-02-07";4564;4322;617,428571428571;382001;619;"2022-10-26";0,0159130388066116
"357";"2021-02-14";"Steiermark";1246395;38152;23741;14411;"2021-02-07";5248;9163;1309;858065;656;"2022-12-02";0,0115621452268342
"358";"2021-02-14";"Tirol";757634;25550;16207;9343;"2021-02-07";4505;4838;691,142857142857;521001;754;"2023-03-10";0,0123318119302988
"359";"2021-02-14";"Vorarlberg";397139;19487;11696;7791;"2021-02-07";3958;3833;547,571428571429;270206;493;"2022-06-22";0,0196178164320301
"360";"2021-02-14";"Wien";1911191;84302;52580;31722;"2021-02-07";13055;18667;2666,71428571429;1306112;490;"2022-06-19";0,0165980270941
"361";"2021-02-13";"Burgenland";294436;12370;7039;5331;"2021-02-06";2045;3286;469,428571428571;200774;428;"2022-04-17";0,0181058022796125
"362";"2021-02-13";"Kärnten";561293;28339;17420;10919;"2021-02-06";6164;4755;679,285714285714;381986;562;"2022-08-29";0,0194532980101302
"363";"2021-02-13";"Niederösterreich";1684287;78965;50973;27992;"2021-02-06";14485;13507;1929,57142857143;1151009;597;"2022-10-03";0,0166194953710383
"364";"2021-02-13";"Oberösterreich";1490279;68845;46161;22684;"2021-02-06";10602;12082;1726;1020511;591;"2022-09-27";0,0152213109088969
"365";"2021-02-13";"Salzburg";558410;20474;11784;8690;"2021-02-06";4516;4174;596,285714285714;382197;641;"2022-11-16";0,0155620422270375
"366";"2021-02-13";"Steiermark";1246395;37562;23552;14010;"2021-02-06";4923;9087;1298,14285714286;858466;661;"2022-12-06";0,0112404173636768
"367";"2021-02-13";"Tirol";757634;24990;15971;9019;"2021-02-06";4249;4770;681,428571428571;521325;765;"2023-03-20";0,0119041648078096
"368";"2021-02-13";"Vorarlberg";397139;18061;11570;6491;"2021-02-06";3798;2693;384,714285714286;271506;706;"2023-01-20";0,0163444033449246
"369";"2021-02-13";"Wien";1911191;83686;52258;31428;"2021-02-06";11341;20087;2869,57142857143;1306406;455;"2022-05-14";0,0164441963152819
"370";"2021-02-12";"Burgenland";294436;11975;6946;5029;"2021-02-05";1664;3365;480,714285714286;201076;418;"2022-04-06";0,0170801124862449
"371";"2021-02-12";"Kärnten";561293;27830;17158;10672;"2021-02-05";6060;4612;658,857142857143;382233;580;"2022-09-15";0,0190132426379805
"372";"2021-02-12";"Niederösterreich";1684287;74851;48669;26182;"2021-02-05";13119;13063;1866,14285714286;1152819;618;"2022-10-23";0,015544856666352
"373";"2021-02-12";"Oberösterreich";1490279;62110;44994;17116;"2021-02-05";7101;10015;1430,71428571429;1026079;717;"2023-01-30";0,011485097756863
"374";"2021-02-12";"Salzburg";558410;19585;11478;8107;"2021-02-05";3459;4648;664;382780;576;"2022-09-11";0,0145180064826919
"375";"2021-02-12";"Steiermark";1246395;35618;22843;12775;"2021-02-05";3955;8820;1260;859701;682;"2022-12-26";0,0102495597302621
"376";"2021-02-12";"Tirol";757634;23989;15450;8539;"2021-02-05";3375;5164;737,714285714286;521805;707;"2023-01-20";0,0112706135152329
"377";"2021-02-12";"Vorarlberg";397139;16985;11301;5684;"2021-02-05";3771;1913;273,285714285714;272313;996;"2023-11-05";0,0143123692208521
"378";"2021-02-12";"Wien";1911191;78723;50478;28245;"2021-02-05";8165;20080;2868,57142857143;1309589;457;"2022-05-15";0,0147787426793031
"379";"2021-02-11";"Burgenland";294436;11528;6873;4655;"2021-02-04";1540;3115;445;201450;453;"2022-05-10";0,0158098873779022
"380";"2021-02-11";"Kärnten";561293;27020;17029;9991;"2021-02-04";4682;5309;758,428571428571;382914;505;"2022-07-01";0,0177999725633493
"381";"2021-02-11";"Niederösterreich";1684287;69667;46899;22768;"2021-02-04";10731;12037;1719,57142857143;1156233;672;"2022-12-15";0,0135178862034796
"382";"2021-02-11";"Oberösterreich";1490279;59015;44581;14434;"2021-02-04";4478;9956;1422,28571428571;1028761;723;"2023-02-04";0,00968543474074318
"383";"2021-02-11";"Salzburg";558410;18499;11157;7342;"2021-02-04";2694;4648;664;383545;578;"2022-09-12";0,0131480453430275
"384";"2021-02-11";"Steiermark";1246395;32343;21837;10506;"2021-02-04";2416;8090;1155,71428571429;861970;746;"2023-02-27";0,00842910955194782
"385";"2021-02-11";"Tirol";757634;23064;15222;7842;"2021-02-04";2394;5448;778,285714285714;522502;671;"2022-12-14";0,0103506442424706
"386";"2021-02-11";"Vorarlberg";397139;16347;11202;5145;"2021-02-04";3746;1399;199,857142857143;272852;1365;"2024-11-07";0,0129551617947369
"387";"2021-02-11";"Wien";1911191;73434;49667;23767;"2021-02-04";6648;17119;2445,57142857143;1314067;537;"2022-08-02";0,0124357010890068
"388";"2021-02-10";"Burgenland";294436;10633;6755;3878;"2021-02-03";1230;2648;378,285714285714;202227;535;"2022-07-30";0,0131709437704629
"389";"2021-02-10";"Kärnten";561293;25712;16714;8998;"2021-02-03";3011;5987;855,285714285714;383907;449;"2022-05-05";0,0160308430712658
"390";"2021-02-10";"Niederösterreich";1684287;64031;45393;18638;"2021-02-03";8336;10302;1471,71428571429;1160363;788;"2023-04-09";0,0110658100430627
"391";"2021-02-10";"Oberösterreich";1490279;57106;44299;12807;"2021-02-03";1181;11626;1660,85714285714;1030388;620;"2022-10-23";0,00859369285885395
"392";"2021-02-10";"Salzburg";558410;17184;10939;6245;"2021-02-03";2109;4136;590,857142857143;384642;651;"2022-11-23";0,0111835389767375
"393";"2021-02-10";"Steiermark";1246395;29742;21043;8699;"2021-02-03";1541;7158;1022,57142857143;863777;845;"2023-06-05";0,00697932838305674
"394";"2021-02-10";"Tirol";757634;21329;14801;6528;"2021-02-03";1416;5112;730,285714285714;523816;717;"2023-01-28";0,00861629757904212
"395";"2021-02-10";"Vorarlberg";397139;15451;11196;4255;"2021-02-03";3657;598;85,4285714285714;273742;3204;"2029-11-19";0,0107141328351031
"396";"2021-02-10";"Wien";1911191;69081;48146;20935;"2021-02-03";5752;15183;2169;1316899;607;"2022-10-10";0,0109539025665148
"397";"2021-02-09";"Burgenland";294436;9248;6656;2592;"2021-02-02";619;1973;281,857142857143;203513;722;"2023-02-01";0,00880327133910255
"398";"2021-02-09";"Kärnten";561293;24375;16240;8135;"2021-02-02";1436;6699;957;384770;402;"2022-03-18";0,0144933216697874
"399";"2021-02-09";"Niederösterreich";1684287;60543;44019;16524;"2021-02-02";5203;11321;1617,28571428571;1162477;719;"2023-01-29";0,00981067953383242
"400";"2021-02-09";"Oberösterreich";1490279;55250;44155;11095;"2021-02-02";1045;10050;1435,71428571429;1032100;719;"2023-01-29";0,0074449146770504
"401";"2021-02-09";"Salzburg";558410;15856;10624;5232;"2021-02-02";1429;3803;543,285714285714;385655;710;"2023-01-20";0,0093694597159793
"402";"2021-02-09";"Steiermark";1246395;27044;20311;6733;"2021-02-02";837;5896;842,285714285714;865743;1028;"2023-12-04";0,00540197930832521
"403";"2021-02-09";"Tirol";757634;20151;14637;5514;"2021-02-02";392;5122;731,714285714286;524830;717;"2023-01-27";0,007277920473474
"404";"2021-02-09";"Vorarlberg";397139;15283;11192;4091;"2021-02-02";3646;445;63,5714285714286;273906;4309;"2032-11-27";0,0103011791841144
"405";"2021-02-09";"Wien";1911191;66694;47758;18936;"2021-02-02";4455;14481;2068,71428571429;1318898;638;"2022-11-09";0,00990795791734055
"406";"2021-02-08";"Burgenland";294436;8942;6583;2359;"2021-02-01";369;1990;284,285714285714;203746;717;"2023-01-26";0,00801192788925267
"407";"2021-02-08";"Kärnten";561293;23475;15467;8008;"2021-02-01";1360;6648;949,714285714286;384897;405;"2022-03-20";0,0142670583812732
"408";"2021-02-08";"Niederösterreich";1684287;58412;43008;15404;"2021-02-01";3887;11517;1645,28571428571;1163597;707;"2023-01-16";0,00914570972761768
"409";"2021-02-08";"Oberösterreich";1490279;55388;44583;10805;"2021-02-01";952;9853;1407,57142857143;1032390;733;"2023-02-11";0,00725032024204864
"410";"2021-02-08";"Salzburg";558410;14996;10276;4720;"2021-02-01";1019;3701;528,714285714286;386167;730;"2023-02-08";0,00845257069178561
"411";"2021-02-08";"Steiermark";1246395;25204;19635;5569;"2021-02-01";504;5065;723,571428571429;866907;1198;"2024-05-21";0,00446808595990838
"412";"2021-02-08";"Tirol";757634;19393;14344;5049;"2021-02-01";371;4678;668,285714285714;525295;786;"2023-04-05";0,00666416765879039
"413";"2021-02-08";"Vorarlberg";397139;15110;11150;3960;"2021-02-01";3579;381;54,4285714285714;274037;5035;"2034-11-22";0,00997131986533682
"414";"2021-02-08";"Wien";1911191;62277;47016;15261;"2021-02-01";3825;11436;1633,71428571429;1322573;810;"2023-04-29";0,00798507318211524
"415";"2021-02-07";"Burgenland";294436;8833;6580;2253;"2021-01-31";336;1917;273,857142857143;203852;744;"2023-02-21";0,00765191756442826
"416";"2021-02-07";"Kärnten";561293;22744;15430;7314;"2021-01-31";1359;5955;850,714285714286;385591;453;"2022-05-06";0,0130306274975815
"417";"2021-02-07";"Niederösterreich";1684287;57746;42792;14954;"2021-01-31";3710;11244;1606,28571428571;1164047;725;"2023-02-02";0,00887853435904926
"418";"2021-02-07";"Oberösterreich";1490279;55330;44560;10770;"2021-01-31";948;9822;1403,14285714286;1032425;736;"2023-02-13";0,0072268347067898
"419";"2021-02-07";"Salzburg";558410;14776;10212;4564;"2021-01-31";955;3609;515,571428571429;386323;749;"2023-02-26";0,00817320606722659
"420";"2021-02-07";"Steiermark";1246395;24799;19551;5248;"2021-01-31";485;4763;680,428571428571;867228;1275;"2024-08-05";0,00421054320660786
"421";"2021-02-07";"Tirol";757634;18605;14100;4505;"2021-01-31";357;4148;592,571428571429;525839;887;"2023-07-14";0,00594614286053688
"422";"2021-02-07";"Vorarlberg";397139;13998;10040;3958;"2021-01-31";3248;710;101,428571428571;274039;2702;"2028-07-02";0,00996628384520281
"423";"2021-02-07";"Wien";1911191;60029;46974;13055;"2021-01-31";3809;9246;1320,85714285714;1324779;1003;"2023-11-07";0,00683081910703849
"424";"2021-02-06";"Burgenland";294436;8565;6520;2045;"2021-01-30";292;1753;250,428571428571;204060;815;"2023-05-02";0,00694548221005584
"425";"2021-02-06";"Kärnten";561293;21533;15369;6164;"2021-01-30";1358;4806;686,571428571429;386741;563;"2022-08-23";0,010981786696075
"426";"2021-02-06";"Niederösterreich";1684287;55936;41451;14485;"2021-01-30";3347;11138;1591,14285714286;1164516;732;"2023-02-08";0,00860007825269684
"427";"2021-02-06";"Oberösterreich";1490279;55148;44546;10602;"2021-01-30";941;9661;1380,14285714286;1032593;748;"2023-02-24";0,0071141041375474
"428";"2021-02-06";"Salzburg";558410;14716;10200;4516;"2021-01-30";853;3663;523,285714285714;386371;738;"2023-02-14";0,00808724772120843
"429";"2021-02-06";"Steiermark";1246395;24332;19409;4923;"2021-01-30";344;4579;654,142857142857;867553;1326;"2024-09-24";0,0039497911978145
"430";"2021-02-06";"Tirol";757634;18170;13921;4249;"2021-01-30";345;3904;557,714285714286;526095;943;"2023-09-07";0,00560824883782935
"431";"2021-02-06";"Vorarlberg";397139;13808;10010;3798;"2021-01-30";2301;1497;213,857142857143;274199;1282;"2024-08-11";0,00956340223448213
"432";"2021-02-06";"Wien";1911191;58059;46718;11341;"2021-01-30";3770;7571;1081,57142857143;1326493;1226;"2024-06-16";0,00593399613120824
"433";"2021-02-05";"Burgenland";294436;8100;6436;1664;"2021-01-29";108;1556;222,285714285714;204441;920;"2023-08-14";0,00565148283497942
"434";"2021-02-05";"Kärnten";561293;21016;14956;6060;"2021-01-29";361;5699;814,142857142857;386845;475;"2022-05-26";0,0107965002235909
"435";"2021-02-05";"Niederösterreich";1684287;52969;39850;13119;"2021-01-29";2432;10687;1526,71428571429;1165882;764;"2023-03-11";0,00778905257833136
"436";"2021-02-05";"Oberösterreich";1490279;49841;42740;7101;"2021-01-29";597;6504;929,142857142857;1036094;1115;"2024-02-25";0,00476487959637088
"437";"2021-02-05";"Salzburg";558410;13248;9789;3459;"2021-01-29";490;2969;424,142857142857;387428;913;"2023-08-07";0,00619437330993356
"438";"2021-02-05";"Steiermark";1246395;22696;18741;3955;"2021-01-29";49;3906;558;868521;1556;"2025-05-11";0,00317315136854689
"439";"2021-02-05";"Tirol";757634;16901;13526;3375;"2021-01-29";102;3273;467,571428571429;526969;1127;"2024-03-08";0,00445465752592941
"440";"2021-02-05";"Vorarlberg";397139;13683;9912;3771;"2021-01-29";646;3125;446,428571428571;274226;614;"2022-10-12";0,00949541596267302
"441";"2021-02-05";"Wien";1911191;54375;46210;8165;"2021-01-29";2372;5793;827,571428571429;1329669;1607;"2025-07-01";0,00427220513282032
"442";"2021-02-04";"Burgenland";294436;7894;6354;1540;"2021-01-28";86;1454;207,714285714286;204565;985;"2023-10-17";0,00523033868141124
"443";"2021-02-04";"Kärnten";561293;19469;14787;4682;"2021-01-28";332;4350;621,428571428571;388223;625;"2022-10-22";0,00834145446317699
"444";"2021-02-04";"Niederösterreich";1684287;49607;38876;10731;"2021-01-28";2160;8571;1224,42857142857;1168270;954;"2023-09-16";0,00637124195579494
"445";"2021-02-04";"Oberösterreich";1490279;46726;42248;4478;"2021-01-28";310;4168;595,428571428571;1038717;1744;"2025-11-14";0,00300480648254454
"446";"2021-02-04";"Salzburg";558410;12125;9431;2694;"2021-01-28";173;2521;360,142857142857;388193;1078;"2024-01-18";0,00482441217026916
"447";"2021-02-04";"Steiermark";1246395;20546;18130;2416;"2021-01-28";44;2372;338,857142857143;870060;2568;"2028-02-16";0,00193839031767618
"448";"2021-02-04";"Tirol";757634;15664;13270;2394;"2021-01-28";100;2294;327,714285714286;527950;1611;"2025-07-04";0,00315983707172593
"449";"2021-02-04";"Vorarlberg";397139;13654;9908;3746;"2021-01-28";646;3100;442,857142857143;274251;619;"2022-10-16";0,00943246571099791
"450";"2021-02-04";"Wien";1911191;52556;45908;6648;"2021-01-28";1782;4866;695,142857142857;1331186;1915;"2026-05-04";0,00347845924347697
"451";"2021-02-03";"Burgenland";294436;7505;6275;1230;"2021-01-27";86;1144;163,428571428571;204875;1254;"2024-07-11";0,0041774782974908
"452";"2021-02-03";"Kärnten";561293;17433;14422;3011;"2021-01-27";327;2684;383,428571428571;389894;1017;"2023-11-17";0,00536439969855316
"453";"2021-02-03";"Niederösterreich";1684287;45574;37238;8336;"2021-01-27";1978;6358;908,285714285714;1170665;1289;"2024-08-15";0,00494927527196968
"454";"2021-02-03";"Oberösterreich";1490279;43053;41872;1181;"2021-01-27";88;1093;156,142857142857;1042014;6673;"2039-05-13";0,000792469061162373
"455";"2021-02-03";"Salzburg";558410;11022;8913;2109;"2021-01-27";107;2002;286;388778;1359;"2024-10-24";0,00377679482817285
"456";"2021-02-03";"Steiermark";1246395;19233;17692;1541;"2021-01-27";42;1499;214,142857142857;870935;4067;"2032-03-24";0,00123636567861713
"457";"2021-02-03";"Tirol";757634;14242;12826;1416;"2021-01-27";97;1319;188,428571428571;528928;2807;"2028-10-11";0,00186897631310105
"458";"2021-02-03";"Vorarlberg";397139;13561;9904;3657;"2021-01-27";642;3015;430,714285714286;274340;637;"2022-11-02";0,00920836281503453
"459";"2021-02-03";"Wien";1911191;50897;45145;5752;"2021-01-27";1759;3993;570,428571428571;1332082;2335;"2027-06-27";0,00300964163184109
"460";"2021-02-02";"Burgenland";294436;6706;6087;619;"2021-01-26";85;534;76,2857142857143;205486;2694;"2028-06-19";0,00210232444402179
"461";"2021-02-02";"Kärnten";561293;15270;13834;1436;"2021-01-26";18;1418;202,571428571429;391469;1932;"2026-05-19";0,00255837860083771
"462";"2021-02-02";"Niederösterreich";1684287;40743;35540;5203;"2021-01-26";1905;3298;471,142857142857;1173798;2491;"2027-11-29";0,00308914098369221
"463";"2021-02-02";"Oberösterreich";1490279;42788;41743;1045;"2021-01-26";81;964;137,714285714286;1042150;7567;"2041-10-22";0,000701210981299475
"464";"2021-02-02";"Salzburg";558410;10068;8639;1429;"2021-01-26";107;1322;188,857142857143;389458;2062;"2026-09-26";0,0025590515929156
"465";"2021-02-02";"Steiermark";1246395;18008;17171;837;"2021-01-26";38;799;114,142857142857;871639;7636;"2041-12-30";0,000671536711877053
"466";"2021-02-02";"Tirol";757634;12946;12554;392;"2021-01-26";97;295;42,1428571428571;529952;12575;"2055-07-09";0,000517400222270912
"467";"2021-02-02";"Vorarlberg";397139;13549;9903;3646;"2021-01-26";268;3378;482,571428571429;274351;569;"2022-08-25";0,00918066470429749
"468";"2021-02-02";"Wien";1911191;48910;44455;4455;"2021-01-26";1747;2708;386,857142857143;1333379;3447;"2030-07-12";0,00233100720964048
"469";"2021-02-01";"Burgenland";294436;6269;5900;369;"2021-01-25";83;286;40,8571428571429;205736;5035;"2034-11-15";0,00125324348924724
"470";"2021-02-01";"Kärnten";561293;14971;13611;1360;"2021-01-25";18;1342;191,714285714286;391545;2042;"2026-09-05";0,00242297694786858
"471";"2021-02-01";"Niederösterreich";1684287;38431;34544;3887;"2021-01-25";1875;2012;287,428571428571;1175114;4088;"2032-04-12";0,00230780146138989
"472";"2021-02-01";"Oberösterreich";1490279;42580;41628;952;"2021-01-25";81;871;124,428571428571;1042243;8376;"2044-01-08";0,000638806559040287
"473";"2021-02-01";"Salzburg";558410;9079;8060;1019;"2021-01-25";100;919;131,285714285714;389868;2970;"2029-03-21";0,00182482405401049
"474";"2021-02-01";"Steiermark";1246395;17109;16605;504;"2021-01-25";38;466;66,5714285714286;871972;13098;"2056-12-12";0,000404366192098011
"475";"2021-02-01";"Tirol";757634;12571;12200;371;"2021-01-25";96;275;39,2857142857143;529973;13490;"2058-01-08";0,000489682353220684
"476";"2021-02-01";"Vorarlberg";397139;13479;9900;3579;"2021-01-25";268;3311;473;274418;580;"2022-09-04";0,0090119580298082
"477";"2021-02-01";"Wien";1911191;47856;44031;3825;"2021-01-25";1747;2078;296,857142857143;1334009;4494;"2033-05-23";0,002001369826459
"478";"2021-01-31";"Burgenland";294436;6232;5896;336;"2021-01-24";83;253;36,1428571428571;205769;5693;"2036-09-02";0,001141164803217
"479";"2021-01-31";"Kärnten";561293;14967;13608;1359;"2021-01-24";16;1343;191,857142857143;391546;2041;"2026-09-03";0,00242119534717162
"480";"2021-01-31";"Niederösterreich";1684287;38210;34500;3710;"2021-01-24";1860;1850;264,285714285714;1175291;4447;"2033-04-05";0,00220271248308631
"481";"2021-01-31";"Oberösterreich";1490279;42237;41289;948;"2021-01-24";81;867;123,857142857143;1042247;8415;"2044-02-15";0,000636122497867849
"482";"2021-01-31";"Salzburg";558410;9005;8050;955;"2021-01-24";100;855;122,142857142857;389932;3192;"2029-10-28";0,00171021292598628
"483";"2021-01-31";"Steiermark";1246395;16619;16134;485;"2021-01-24";38;447;63,8571428571429;871991;13655;"2058-06-21";0,000389122228507014
"484";"2021-01-31";"Tirol";757634;12269;11912;357;"2021-01-24";96;261;37,2857142857143;529987;14214;"2060-01-01";0,000471203773853866
"485";"2021-01-31";"Vorarlberg";397139;13133;9885;3248;"2021-01-24";268;2980;425,714285714286;274749;645;"2022-11-07";0,0081784966976298
"486";"2021-01-31";"Wien";1911191;47826;44017;3809;"2021-01-24";1747;2062;294,571428571429;1334025;4529;"2033-06-26";0,00199299808339407
"487";"2021-01-30";"Burgenland";294436;6174;5882;292;"2021-01-23";83;209;29,8571428571429;205813;6893;"2039-12-15";0,000991726555176677
"488";"2021-01-30";"Kärnten";561293;14966;13608;1358;"2021-01-23";13;1345;192,142857142857;391547;2038;"2026-08-30";0,00241941374647466
"489";"2021-01-30";"Niederösterreich";1684287;37617;34270;3347;"2021-01-23";1819;1528;218,285714285714;1175654;5386;"2035-10-30";0,00198719101910779
"490";"2021-01-30";"Oberösterreich";1490279;41139;40198;941;"2021-01-23";80;861;123;1042254;8474;"2044-04-13";0,000631425390816082
"491";"2021-01-30";"Salzburg";558410;8885;8032;853;"2021-01-23";100;753;107,571428571429;390034;3626;"2031-01-04";0,0015275514406977
"492";"2021-01-30";"Steiermark";1246395;16322;15978;344;"2021-01-23";38;306;43,7142857142857;872132;19951;"2075-09-15";0,000275995972384356
"493";"2021-01-30";"Tirol";757634;12224;11879;345;"2021-01-23";96;249;35,5714285714286;529999;14900;"2061-11-16";0,00045536499153945
"494";"2021-01-30";"Vorarlberg";397139;12083;9782;2301;"2021-01-23";267;2034;290,571428571429;275696;949;"2023-09-06";0,00579394116417677
"495";"2021-01-30";"Wien";1911191;47769;43999;3770;"2021-01-23";1747;2023;289;1334064;4616;"2033-09-20";0,00197259195967331
"496";"2021-01-29";"Burgenland";294436;5943;5835;108;"2021-01-22";73;35;5;205997;41199;"2133-11-17";0,000366802972462606
"497";"2021-01-29";"Kärnten";561293;13555;13194;361;"2021-01-22";13;348;49,7142857142857;392544;7896;"2042-09-12";0,000643157851603352
"498";"2021-01-29";"Niederösterreich";1684287;35296;32864;2432;"2021-01-22";1469;963;137,571428571429;1176569;8552;"2044-06-29";0,001443934436352
"499";"2021-01-29";"Oberösterreich";1490279;36481;35884;597;"2021-01-22";77;520;74,2857142857143;1042598;14035;"2059-07-04";0,000400596129986399
"500";"2021-01-29";"Salzburg";558410;7988;7498;490;"2021-01-22";100;390;55,7142857142857;390397;7007;"2040-04-06";0,00087749144893537
"501";"2021-01-29";"Steiermark";1246395;15327;15278;49;"2021-01-22";38;11;1,57142857142857;872427;555181;"3541-02-11";3,93133797873066e-05
"502";"2021-01-29";"Tirol";757634;11175;11073;102;"2021-01-22";96;6;0,857142857142857;530242;618616;"3714-10-17";0,000134629649672533
"503";"2021-01-29";"Vorarlberg";397139;10424;9778;646;"2021-01-22";267;379;54,1428571428571;277351;5123;"2035-02-08";0,00162663450328474
"504";"2021-01-29";"Wien";1911191;45230;42858;2372;"2021-01-22";1407;965;137,857142857143;1335462;9687;"2047-08-08";0,00124111090937536
"505";"2021-01-28";"Burgenland";294436;5609;5523;86;"2021-01-21";73;13;1,85714285714286;206019;110933;"2324-10-20";0,000292083848442446
"506";"2021-01-28";"Kärnten";561293;13250;12918;332;"2021-01-21";13;319;45,5714285714286;392573;8614;"2044-08-29";0,000591491431391448
"507";"2021-01-28";"Niederösterreich";1684287;33326;31166;2160;"2021-01-21";1174;986;140,857142857143;1176841;8355;"2043-12-14";0,00128244176912842
"508";"2021-01-28";"Oberösterreich";1490279;33186;32876;310;"2021-01-21";74;236;33,7142857142857;1042885;30933;"2105-10-08";0,000208014740863959
"509";"2021-01-28";"Salzburg";558410;7100;6927;173;"2021-01-21";100;73;10,4285714285714;390714;37466;"2123-08-28";0,000309808205440447
"510";"2021-01-28";"Steiermark";1246395;13970;13926;44;"2021-01-21";36;8;1,14285714285714;872432;763378;"4111-02-19";3,53018104212549e-05
"511";"2021-01-28";"Tirol";757634;9485;9385;100;"2021-01-21";96;4;0,571428571428571;530244;927927;"4561-08-27";0,000131989852620131
"512";"2021-01-28";"Vorarlberg";397139;10228;9582;646;"2021-01-21";267;379;54,1428571428571;277351;5123;"2035-02-07";0,00162663450328474
"513";"2021-01-28";"Wien";1911191;43285;41503;1782;"2021-01-21";1381;401;57,2857142857143;1336052;23323;"2084-12-06";0,000932402883856192
"514";"2021-01-27";"Burgenland";294436;5400;5314;86;"2021-01-20";48;38;5,42857142857143;206019;37951;"2124-12-24";0,000292083848442446
"515";"2021-01-27";"Kärnten";561293;12993;12666;327;"2021-01-20";12;315;45;392578;8724;"2044-12-16";0,000582583427906637
"516";"2021-01-27";"Niederösterreich";1684287;31561;29583;1978;"2021-01-20";718;1260;180;1177023;6539;"2038-12-23";0,00117438417561853
"517";"2021-01-27";"Oberösterreich";1490279;30826;30738;88;"2021-01-20";17;71;10,1428571428571;1043107;102842;"2302-08-25";5,904934579364e-05
"518";"2021-01-27";"Salzburg";558410;6802;6695;107;"2021-01-20";87;20;2,85714285714286;390780;136773;"2395-07-19";0,000191615479665479
"519";"2021-01-27";"Steiermark";1246395;13377;13335;42;"2021-01-20";33;9;1,28571428571429;872434;678560;"3878-11-28";3,36971826748342e-05
"520";"2021-01-27";"Tirol";757634;8590;8493;97;"2021-01-20";95;2;0,285714285714286;530247;1855864;"7102-04-05";0,000128030157041527
"521";"2021-01-27";"Vorarlberg";397139;10062;9420;642;"2021-01-20";266;376;53,7142857142857;277355;5164;"2035-03-19";0,00161656246301673
"522";"2021-01-27";"Wien";1911191;39374;37615;1759;"2021-01-20";731;1028;146,857142857143;1336075;9098;"2045-12-25";0,00092036850320036
"523";"2021-01-26";"Burgenland";294436;5184;5099;85;"2021-01-19";6;79;11,2857142857143;206020;18255;"2071-01-19";0,000288687524623348
"524";"2021-01-26";"Kärnten";561293;12626;12608;18;"2021-01-19";10;8;1,14285714285714;392887;343776;"2962-04-19";3,20688125453195e-05
"525";"2021-01-26";"Niederösterreich";1684287;30203;28298;1905;"2021-01-19";260;1645;235;1177096;5009;"2034-10-14";0,00113104239360632
"526";"2021-01-26";"Oberösterreich";1490279;28687;28606;81;"2021-01-19";11;70;10;1043114;104311;"2306-09-01";5,43522387418732e-05
"527";"2021-01-26";"Salzburg";558410;6670;6563;107;"2021-01-19";86;21;3;390780;130260;"2377-09-17";0,000191615479665479
"528";"2021-01-26";"Steiermark";1246395;12545;12507;38;"2021-01-19";5;33;4,71428571428571;872438;185063;"2527-10-04";3,04879271819929e-05
"529";"2021-01-26";"Tirol";757634;7846;7749;97;"2021-01-19";2;95;13,5714285714286;530247;39071;"2128-01-17";0,000128030157041527
"530";"2021-01-26";"Vorarlberg";397139;9531;9263;268;"2021-01-19";266;2;0,285714285714286;277729;972052;"4682-06-17";0,000674826697957138
"531";"2021-01-26";"Wien";1911191;37641;35894;1747;"2021-01-19";388;1359;194,142857142857;1336087;6882;"2039-11-30";0,000914089695901665
"532";"2021-01-25";"Burgenland";294436;4931;4848;83;"2021-01-18";2;81;11,5714285714286;206022;17804;"2069-10-24";0,000281894876985151
"533";"2021-01-25";"Kärnten";561293;12622;12604;18;"2021-01-18";10;8;1,14285714285714;392887;343776;"2962-04-18";3,20688125453195e-05
"534";"2021-01-25";"Niederösterreich";1684287;24622;22747;1875;"2021-01-18";10;1865;266,428571428571;1177126;4418;"2033-03-01";0,00111323070236842
"535";"2021-01-25";"Oberösterreich";1490279;27949;27868;81;"2021-01-18";10;71;10,1428571428571;1043114;102842;"2302-08-23";5,43522387418732e-05
"536";"2021-01-25";"Salzburg";558410;6316;6216;100;"2021-01-18";1;99;14,1428571428571;390787;27631;"2096-09-19";0,000179079887537831
"537";"2021-01-25";"Steiermark";1246395;11604;11566;38;"2021-01-18";0;38;5,42857142857143;872438;160712;"2461-01-30";3,04879271819929e-05
"538";"2021-01-25";"Tirol";757634;7277;7181;96;"2021-01-18";2;94;13,4285714285714;530248;39487;"2129-03-07";0,000126710258515325
"539";"2021-01-25";"Vorarlberg";397139;9526;9258;268;"2021-01-18";266;2;0,285714285714286;277729;972052;"4682-06-16";0,000674826697957138
"540";"2021-01-25";"Wien";1911191;36503;34756;1747;"2021-01-18";3;1744;249,142857142857;1336087;5363;"2035-10-02";0,000914089695901665
"541";"2021-01-24";"Burgenland";294436;4931;4848;83;"2021-01-17";0;83;11,8571428571429;206022;17375;"2068-08-20";0,000281894876985151
"542";"2021-01-24";"Kärnten";561293;12014;11998;16;"2021-01-17";0;16;2,28571428571429;392889;171889;"2491-09-06";2,85056111513951e-05
"543";"2021-01-24";"Niederösterreich";1684287;24391;22531;1860;"2021-01-17";0;1860;265,714285714286;1177141;4430;"2033-03-12";0,00110432485674947
"544";"2021-01-24";"Oberösterreich";1490279;27466;27385;81;"2021-01-17";0;81;11,5714285714286;1043114;90146;"2267-11-17";5,43522387418732e-05
"545";"2021-01-24";"Salzburg";558410;6316;6216;100;"2021-01-17";0;100;14,2857142857143;390787;27355;"2095-12-17";0,000179079887537831
"546";"2021-01-24";"Steiermark";1246395;11262;11224;38;"2021-01-17";0;38;5,42857142857143;872438;160712;"2461-01-29";3,04879271819929e-05
"547";"2021-01-24";"Tirol";757634;7132;7036;96;"2021-01-17";0;96;13,7142857142857;530248;38664;"2126-12-04";0,000126710258515325
"548";"2021-01-24";"Vorarlberg";397139;9525;9257;268;"2021-01-17";0;268;38,2857142857143;277729;7254;"2040-12-04";0,000674826697957138
"549";"2021-01-24";"Wien";1911191;36501;34754;1747;"2021-01-17";0;1747;249,571428571429;1336087;5354;"2035-09-22";0,000914089695901665
"550";"2021-01-23";"Burgenland";294436;4905;4822;83;"2021-01-16";0;83;11,8571428571429;206022;17375;"2068-08-19";0,000281894876985151
"551";"2021-01-23";"Kärnten";561293;11027;11014;13;"2021-01-16";0;13;1,85714285714286;392892;211557;"2600-04-15";2,31608090605085e-05
"552";"2021-01-23";"Niederösterreich";1684287;24142;22323;1819;"2021-01-16";0;1819;259,857142857143;1177182;4530;"2033-06-19";0,00107998221205768
"553";"2021-01-23";"Oberösterreich";1490279;26854;26774;80;"2021-01-16";0;80;11,4285714285714;1043115;91273;"2270-12-17";5,36812234487636e-05
"554";"2021-01-23";"Salzburg";558410;6104;6004;100;"2021-01-16";0;100;14,2857142857143;390787;27355;"2095-12-16";0,000179079887537831
"555";"2021-01-23";"Steiermark";1246395;10978;10940;38;"2021-01-16";0;38;5,42857142857143;872438;160712;"2461-01-28";3,04879271819929e-05
"556";"2021-01-23";"Tirol";757634;6596;6500;96;"2021-01-16";0;96;13,7142857142857;530248;38664;"2126-12-03";0,000126710258515325
"557";"2021-01-23";"Vorarlberg";397139;9458;9191;267;"2021-01-16";0;267;38,1428571428571;277730;7281;"2040-12-30";0,000672308687890134
"558";"2021-01-23";"Wien";1911191;36284;34537;1747;"2021-01-16";0;1747;249,571428571429;1336087;5354;"2035-09-21";0,000914089695901665
"559";"2021-01-22";"Burgenland";294436;4318;4245;73;"2021-01-15";0;73;10,4285714285714;206032;19756;"2075-02-24";0,000247931638794169
"560";"2021-01-22";"Kärnten";561293;10687;10674;13;"2021-01-15";0;13;1,85714285714286;392892;211557;"2600-04-14";2,31608090605085e-05
"561";"2021-01-22";"Niederösterreich";1684287;21922;20453;1469;"2021-01-15";0;1469;209,857142857143;1177532;5611;"2036-06-03";0,000872179147615579
"562";"2021-01-22";"Oberösterreich";1490279;24140;24063;77;"2021-01-15";0;77;11;1043118;94829;"2280-09-10";5,1668177569435e-05
"563";"2021-01-22";"Salzburg";558410;5728;5628;100;"2021-01-15";0;100;14,2857142857143;390787;27355;"2095-12-15";0,000179079887537831
"564";"2021-01-22";"Steiermark";1246395;9846;9808;38;"2021-01-15";0;38;5,42857142857143;872438;160712;"2461-01-27";3,04879271819929e-05
"565";"2021-01-22";"Tirol";757634;6213;6117;96;"2021-01-15";0;96;13,7142857142857;530248;38664;"2126-12-02";0,000126710258515325
"566";"2021-01-22";"Vorarlberg";397139;9249;8982;267;"2021-01-15";0;267;38,1428571428571;277730;7281;"2040-12-29";0,000672308687890134
"567";"2021-01-22";"Wien";1911191;32653;31246;1407;"2021-01-15";0;1407;201;1336427;6649;"2039-04-07";0,000736190155771977
"568";"2021-01-21";"Burgenland";294436;3876;3803;73;"2021-01-14";0;73;10,4285714285714;206032;19756;"2075-02-23";0,000247931638794169
"569";"2021-01-21";"Kärnten";561293;9848;9835;13;"2021-01-14";0;13;1,85714285714286;392892;211557;"2600-04-13";2,31608090605085e-05
"570";"2021-01-21";"Niederösterreich";1684287;18627;17453;1174;"2021-01-14";0;1174;167,714285714286;1177827;7023;"2040-04-14";0,000697030850442947
"571";"2021-01-21";"Oberösterreich";1490279;19629;19555;74;"2021-01-14";0;74;10,5714285714286;1043121;98674;"2291-03-21";4,96551316901063e-05
"572";"2021-01-21";"Salzburg";558410;4612;4512;100;"2021-01-14";0;100;14,2857142857143;390787;27355;"2095-12-14";0,000179079887537831
"573";"2021-01-21";"Steiermark";1246395;8189;8153;36;"2021-01-14";0;36;5,14285714285714;872440;169641;"2485-07-08";2,88832994355722e-05
"574";"2021-01-21";"Tirol";757634;5768;5672;96;"2021-01-14";0;96;13,7142857142857;530248;38664;"2126-12-01";0,000126710258515325
"575";"2021-01-21";"Vorarlberg";397139;8990;8723;267;"2021-01-14";0;267;38,1428571428571;277730;7281;"2040-12-28";0,000672308687890134
"576";"2021-01-21";"Wien";1911191;28713;27332;1381;"2021-01-14";0;1381;197,285714285714;1336453;6774;"2039-08-09";0,000722586073291471
"577";"2021-01-20";"Burgenland";294436;3320;3272;48;"2021-01-13";0;48;6,85714285714286;206057;30050;"2103-05-01";0,000163023543316714
"578";"2021-01-20";"Kärnten";561293;9009;8997;12;"2021-01-13";0;12;1,71428571428571;392893;229188;"2648-07-20";2,13792083635463e-05
"579";"2021-01-20";"Niederösterreich";1684287;14075;13357;718;"2021-01-13";0;718;102,571428571429;1178283;11487;"2052-07-03";0,000426293143626947
"580";"2021-01-20";"Oberösterreich";1490279;15242;15225;17;"2021-01-13";0;17;2,42857142857143;1043178;429544;"3197-02-08";1,14072599828623e-05
"581";"2021-01-20";"Salzburg";558410;3593;3506;87;"2021-01-13";0;87;12,4285714285714;390800;31444;"2107-02-23";0,000155799502157913
"582";"2021-01-20";"Steiermark";1246395;6037;6004;33;"2021-01-13";0;33;4,71428571428571;872443;185064;"2527-09-29";2,64763578159412e-05
"583";"2021-01-20";"Tirol";757634;4579;4484;95;"2021-01-13";0;95;13,5714285714286;530249;39071;"2128-01-11";0,000125390359989124
"584";"2021-01-20";"Vorarlberg";397139;8724;8458;266;"2021-01-13";0;266;38;277731;7309;"2041-01-24";0,00066979067782313
"585";"2021-01-20";"Wien";1911191;24316;23585;731;"2021-01-13";0;731;104,428571428571;1337103;12804;"2056-02-10";0,000382484011278831
"586";"2021-01-19";"Burgenland";294436;2708;2702;6;"2021-01-12";0;6;0,857142857142857;206099;240449;"2679-05-19";2,03779429145892e-05
"587";"2021-01-19";"Kärnten";561293;8325;8315;10;"2021-01-12";0;10;1,42857142857143;392895;275026;"2774-01-18";1,78160069696219e-05
"588";"2021-01-19";"Niederösterreich";1684287;10779;10519;260;"2021-01-12";0;260;37,1428571428571;1178741;31735;"2107-12-10";0,000154367990728421
"589";"2021-01-19";"Oberösterreich";1490279;10288;10277;11;"2021-01-12";0;11;1,57142857142857;1043184;663844;"3838-08-06";7,381168224205e-06
"590";"2021-01-19";"Salzburg";558410;2621;2535;86;"2021-01-12";0;86;12,2857142857143;390801;31809;"2108-02-22";0,000154008703282534
"591";"2021-01-19";"Steiermark";1246395;4311;4306;5;"2021-01-12";0;5;0,714285714285714;872471;1221459;"5365-04-17";4,01156936605169e-06
"592";"2021-01-19";"Tirol";757634;3433;3431;2;"2021-01-12";0;2;0,285714285714286;530342;1856197;"7103-02-24";2,63979705240261e-06
"593";"2021-01-19";"Vorarlberg";397139;8366;8100;266;"2021-01-12";0;266;38;277731;7309;"2041-01-23";0,00066979067782313
"594";"2021-01-19";"Wien";1911191;20677;20289;388;"2021-01-12";0;388;55,4285714285714;1337446;24129;"2087-02-11";0,000203014769324468
"595";"2021-01-18";"Burgenland";294436;2098;2096;2;"2021-01-11";0;2;0,285714285714286;206103;721360;"3996-01-25";6,79264763819642e-06
"596";"2021-01-18";"Kärnten";561293;8279;8269;10;"2021-01-11";0;10;1,42857142857143;392895;275026;"2774-01-17";1,78160069696219e-05
"597";"2021-01-18";"Niederösterreich";1684287;8624;8614;10;"2021-01-11";0;10;1,42857142857143;1178991;825294;"4280-08-17";5,93723041263158e-06
"598";"2021-01-18";"Oberösterreich";1490279;9500;9490;10;"2021-01-11";0;10;1,42857142857143;1043185;730230;"4020-05-08";6,71015293109545e-06
"599";"2021-01-18";"Salzburg";558410;2094;2093;1;"2021-01-11";0;1;0,142857142857143;390886;2736202;"9512-07-08";1,79079887537831e-06
"600";"2021-01-18";"Steiermark";1246395;3246;3246;0;"2021-01-11";0;0;0;872476;NA;NA;0
"601";"2021-01-18";"Tirol";757634;2847;2845;2;"2021-01-11";0;2;0,285714285714286;530342;1856197;"7103-02-23";2,63979705240261e-06
"602";"2021-01-18";"Vorarlberg";397139;8226;7960;266;"2021-01-11";0;266;38;277731;7309;"2041-01-22";0,00066979067782313
"603";"2021-01-18";"Wien";1911191;16098;16095;3;"2021-01-11";0;3;0,428571428571429;1337831;3121606;"10567-09-19";1,56970182467372e-06
"604";"2021-01-17";"Burgenland";294436;1981;1981;0;"2021-01-10";0;0;0;206105;NA;NA;0
"605";"2021-01-17";"Kärnten";561293;7563;7563;0;"2021-01-10";0;0;0;392905;NA;NA;0
"606";"2021-01-17";"Niederösterreich";1684287;7981;7981;0;"2021-01-10";0;0;0;1179001;NA;NA;0
"607";"2021-01-17";"Oberösterreich";1490279;9388;9388;0;"2021-01-10";0;0;0;1043195;NA;NA;0
"608";"2021-01-17";"Salzburg";558410;1890;1890;0;"2021-01-10";0;0;0;390887;NA;NA;0
"609";"2021-01-17";"Steiermark";1246395;2690;2690;0;"2021-01-10";0;0;0;872476;NA;NA;0
"610";"2021-01-17";"Tirol";757634;2565;2565;0;"2021-01-10";0;0;0;530344;NA;NA;0
"611";"2021-01-17";"Vorarlberg";397139;7268;7268;0;"2021-01-10";0;0;0;277997;NA;NA;0
"612";"2021-01-17";"Wien";1911191;14124;14124;0;"2021-01-10";0;0;0;1337834;NA;NA;0
"613";"2021-01-16";"Burgenland";294436;1862;1862;0;NA;NA;NA;NA;206105;NA;NA;0
"614";"2021-01-16";"Kärnten";561293;6496;6496;0;NA;NA;NA;NA;392905;NA;NA;0
"615";"2021-01-16";"Niederösterreich";1684287;7572;7572;0;NA;NA;NA;NA;1179001;NA;NA;0
"616";"2021-01-16";"Oberösterreich";1490279;9225;9225;0;NA;NA;NA;NA;1043195;NA;NA;0
"617";"2021-01-16";"Salzburg";558410;1554;1554;0;NA;NA;NA;NA;390887;NA;NA;0
"618";"2021-01-16";"Steiermark";1246395;2345;2345;0;NA;NA;NA;NA;872476;NA;NA;0
"619";"2021-01-16";"Tirol";757634;2469;2469;0;NA;NA;NA;NA;530344;NA;NA;0
"620";"2021-01-16";"Vorarlberg";397139;6560;6560;0;NA;NA;NA;NA;277997;NA;NA;0
"621";"2021-01-16";"Wien";1911191;12319;12319;0;NA;NA;NA;NA;1337834;NA;NA;0
"622";"2021-01-15";"Burgenland";294436;1100;1100;0;NA;NA;NA;NA;206105;NA;NA;0
"623";"2021-01-15";"Kärnten";561293;6475;6475;0;NA;NA;NA;NA;392905;NA;NA;0
"624";"2021-01-15";"Niederösterreich";1684287;5950;5950;0;NA;NA;NA;NA;1179001;NA;NA;0
"625";"2021-01-15";"Oberösterreich";1490279;7225;7225;0;NA;NA;NA;NA;1043195;NA;NA;0
"626";"2021-01-15";"Salzburg";558410;1092;1092;0;NA;NA;NA;NA;390887;NA;NA;0
"627";"2021-01-15";"Steiermark";1246395;1351;1351;0;NA;NA;NA;NA;872476;NA;NA;0
"628";"2021-01-15";"Tirol";757634;2093;2093;0;NA;NA;NA;NA;530344;NA;NA;0
"629";"2021-01-15";"Vorarlberg";397139;5534;5534;0;NA;NA;NA;NA;277997;NA;NA;0
"630";"2021-01-15";"Wien";1911191;8931;8931;0;NA;NA;NA;NA;1337834;NA;NA;0
"631";"2021-01-14";"Burgenland";294436;861;861;0;NA;NA;NA;NA;206105;NA;NA;0
"632";"2021-01-14";"Kärnten";561293;5060;5060;0;NA;NA;NA;NA;392905;NA;NA;0
"633";"2021-01-14";"Niederösterreich";1684287;3560;3560;0;NA;NA;NA;NA;1179001;NA;NA;0
"634";"2021-01-14";"Oberösterreich";1490279;4768;4768;0;NA;NA;NA;NA;1043195;NA;NA;0
"635";"2021-01-14";"Salzburg";558410;972;972;0;NA;NA;NA;NA;390887;NA;NA;0
"636";"2021-01-14";"Steiermark";1246395;682;682;0;NA;NA;NA;NA;872476;NA;NA;0
"637";"2021-01-14";"Tirol";757634;1273;1273;0;NA;NA;NA;NA;530344;NA;NA;0
"638";"2021-01-14";"Vorarlberg";397139;5051;5051;0;NA;NA;NA;NA;277997;NA;NA;0
"639";"2021-01-14";"Wien";1911191;7132;7132;0;NA;NA;NA;NA;1337834;NA;NA;0
"640";"2021-01-13";"Burgenland";294436;496;496;0;NA;NA;NA;NA;206105;NA;NA;0
"641";"2021-01-13";"Kärnten";561293;3366;3366;0;NA;NA;NA;NA;392905;NA;NA;0
"642";"2021-01-13";"Niederösterreich";1684287;1763;1763;0;NA;NA;NA;NA;1179001;NA;NA;0
"643";"2021-01-13";"Oberösterreich";1490279;2615;2615;0;NA;NA;NA;NA;1043195;NA;NA;0
"644";"2021-01-13";"Salzburg";558410;859;859;0;NA;NA;NA;NA;390887;NA;NA;0
"645";"2021-01-13";"Steiermark";1246395;530;530;0;NA;NA;NA;NA;872476;NA;NA;0
"646";"2021-01-13";"Tirol";757634;557;557;0;NA;NA;NA;NA;530344;NA;NA;0
"647";"2021-01-13";"Vorarlberg";397139;3901;3901;0;NA;NA;NA;NA;277997;NA;NA;0
"648";"2021-01-13";"Wien";1911191;5977;5977;0;NA;NA;NA;NA;1337834;NA;NA;0
"649";"2021-01-12";"Burgenland";294436;127;127;0;NA;NA;NA;NA;206105;NA;NA;0
"650";"2021-01-12";"Kärnten";561293;1549;1549;0;NA;NA;NA;NA;392905;NA;NA;0
"651";"2021-01-12";"Niederösterreich";1684287;1097;1097;0;NA;NA;NA;NA;1179001;NA;NA;0
"652";"2021-01-12";"Oberösterreich";1490279;886;886;0;NA;NA;NA;NA;1043195;NA;NA;0
"653";"2021-01-12";"Salzburg";558410;523;523;0;NA;NA;NA;NA;390887;NA;NA;0
"654";"2021-01-12";"Steiermark";1246395;322;322;0;NA;NA;NA;NA;872476;NA;NA;0
"655";"2021-01-12";"Tirol";757634;175;175;0;NA;NA;NA;NA;530344;NA;NA;0
"656";"2021-01-12";"Vorarlberg";397139;3598;3598;0;NA;NA;NA;NA;277997;NA;NA;0
"657";"2021-01-12";"Wien";1911191;4895;4895;0;NA;NA;NA;NA;1337834;NA;NA;0
"658";"2021-01-11";"Burgenland";294436;64;64;0;NA;NA;NA;NA;206105;NA;NA;0
"659";"2021-01-11";"Kärnten";561293;1472;1472;0;NA;NA;NA;NA;392905;NA;NA;0
"660";"2021-01-11";"Niederösterreich";1684287;1014;1014;0;NA;NA;NA;NA;1179001;NA;NA;0
"661";"2021-01-11";"Oberösterreich";1490279;757;757;0;NA;NA;NA;NA;1043195;NA;NA;0
"662";"2021-01-11";"Salzburg";558410;331;331;0;NA;NA;NA;NA;390887;NA;NA;0
"663";"2021-01-11";"Steiermark";1246395;211;211;0;NA;NA;NA;NA;872476;NA;NA;0
"664";"2021-01-11";"Tirol";757634;154;154;0;NA;NA;NA;NA;530344;NA;NA;0
"665";"2021-01-11";"Vorarlberg";397139;3597;3597;0;NA;NA;NA;NA;277997;NA;NA;0
"666";"2021-01-11";"Wien";1911191;3959;3959;0;NA;NA;NA;NA;1337834;NA;NA;0
"667";"2021-01-10";"Burgenland";294436;64;64;0;NA;NA;NA;NA;206105;NA;NA;0
"668";"2021-01-10";"Kärnten";561293;1472;1472;0;NA;NA;NA;NA;392905;NA;NA;0
"669";"2021-01-10";"Niederösterreich";1684287;1013;1013;0;NA;NA;NA;NA;1179001;NA;NA;0
"670";"2021-01-10";"Oberösterreich";1490279;753;753;0;NA;NA;NA;NA;1043195;NA;NA;0
"671";"2021-01-10";"Salzburg";558410;310;310;0;NA;NA;NA;NA;390887;NA;NA;0
"672";"2021-01-10";"Steiermark";1246395;210;210;0;NA;NA;NA;NA;872476;NA;NA;0
"673";"2021-01-10";"Tirol";757634;138;138;0;NA;NA;NA;NA;530344;NA;NA;0
"674";"2021-01-10";"Vorarlberg";397139;2824;2824;0;NA;NA;NA;NA;277997;NA;NA;0
"675";"2021-01-10";"Wien";1911191;0;0;0;NA;NA;NA;NA;1337834;NA;NA;0
